Abbrecherquote	Abbruchquote
Abenteurer (sg.)	Waghals; abenteuerliebende Person; abenteuerlustige Person; abenteuermutige Person; Abenteuermensch
Abgänger	absolvierende Person; Abschluss innehabende Person
Abgeordneter	abgeordnete Person für ...
Abiturient	Abitur ablegende Person; Person, die Abitur macht
Abkömmling	abstammende Person; nachkommende Person; Kind; Kindeskind; Person gleicher Abstammung
Ableser	Ablesedienst
Abnehmer (pl.)	Abnehmende
Abonnent	Bezugsperson; medienbeziehende Person; ein Abonnement beziehende Person
Abonnenten	Abonnement-Beziehende; Abonnierende; Followers; Follis
Absender (sg./pl.)	abgesandt durch ...; absendende Person; von ...
Absolventen (pl.)	 Abschluss innehabende Person; Person mit Abschluss
Absolventenpraktikum	Praktikum (direkt) nach Studienabschluss
Alumnivorsprechen 	Abschlussvorsprechen; Absolventenvorsprechen [Schauspielschule]
Abteilungsleiter (sg.)	Abteilungsleitung
Abteilungsleiter (pl.)	Abteilungsleitungen; Abteilungsleitende
Abteilungsleitertreffen	Treffen der Abteilungsleitungen; Treffen der Leitungsebene
Administrator	Administration; Admin
Administratoren	Administration; Admins; Administrierende
Adressat	adressierte Person; an ...
adressatengerecht	zielgruppengerecht
Adressatenkreis	Zielgruppe
Agent [Spion]	auskundschaftende Person; spionierende Person
Agent [Sport-/Kunst-/...-Agent]	jemanden/etwas vermittelnde Person
Agentenfilm	Spionagefilm
Agententhriller	Spionagethriller
Ahnen (pl.)	[dieser Begriff ist im Plural bereits genderneutral: sg. die Ahne (f.) oder der Ahne (m.) -> pl. die Ahnen (f.) und die Ahnen (m.)]
Akademiker (pl.)	Studierte; Personen mit Hochschulabschluss
Akteure (pl.)	Beteiligte; Agierende; Handelnde; Aktive
Akteursnetzwerk	Netzwerk von Engagierten; Netzwerk von Aktiven
Aktionär	Person mit Aktieneigentum
Aktionäre	Aktien-/Anteilshabende
Aktionärsversammlung	Versammlung von Personen mit Aktienbesitz; Versammlung von Anteilshabenden
Aktivist	engagierte Person; politisch aktiver Mensch
Aktivisten	engagierte Personen; politisch aktive Menschen; zielstrebig Handelnde
Alkoholiker (sg.)	alkoholsüchtige Person; Person mit Alkoholsucht
Alkoholiker (pl.)	Alkoholsüchtige; Menschen mit Alkoholsucht
Alleinerziehende (sg.)	Ein-Eltern-Haushalt; Ein-Eltern-Familie; alleinerziehende Person
Allergiker (pl.)	Menschen mit Allergie; Allergiegeplagte; allergieleidende Personen
Alleskönner	Multitalent; Universalgenie; vielseitig begabter Mensch
Allgemeinmediziner	Allgemeinmedizin praktizierende Person
Alltagshelden	Tag versüßende Personen; Ehrenamtliche; Zivilcourage leistende Personen
Alltagshelfer	Alltagshilfe
Alpinisten	bergsteigende Personen; bergbesteigende Personen; Bergsteigende; Bergkletternde
Älpler (pl.)	Alpwirtschaft Betreibende
Altenpfleger	Pflegefachkraft; Pflegefachperson; Altenpflegeperson; Krankenpflegeperson; Fachkraft für Altenpflege
Altersgenossen	gleich Alte; Menschen derselben Altersgruppe; Gleichaltrige;
Ältestenrat	Menschen; Rat der Erfahrenen; Beratungsgruppe der ältesten Menschen; Gremium der ältesten Menschen; Senioritätsrat]
Altkanzler (pl.)	ehemalige Regierungsoberhäupter
Amateur	Neuling; Person ohne Vorkenntnisse; unerfahrene Person
Amateure	Anfangende; Beginnende; Ungeübte
Ampelmännchen	Ampelfiguren; Ampelfigürchen; Ampelmenschlein
Amtsinhaber (sg.)	Amt innehabende Person; eine mit einem Amt betraute Person; amtierende Person im Bereich XY/ in Position XY; amtsverantwortliche Person für den Bereich XY
Analphabet	leseunfähige Person; leseunkundige Person; Person ohne Lesefähigkeit; des Lesens nicht mächtige Person; des Lesens unkundige Person; Person, die nicht lesen und schreiben kann
Analytiker (pl.)	Analysierende
Anbieter (sg.)	Angebot (von ...); Herstellung; angebotsstellende Person; angebotsmachende Person
Anbieter (pl.)	Angebot (von ...); Herstellung; Anbietende
(der) andere	Gegenüber
der ein oder andere	... die eine oder der andere
Anfänger (pl.)	Unerfahrene; Menschen ohne Vorkenntnisse; Menschen ohne Vorerfahrung; Beginnende; Neulinge
Anfängerkurs	Einstiegskurs; Grundkurs; Kurs für Menschen ohne Vorkenntnisse; Kurs für Menschen ohne Vorerfahrung
Anforderer	anfordernde Person/Abteilung
Anführer (sg.)	Führungsfigur; anführende Person; Führung; Leitung; leitende Person; Oberhaupt
Angehöriger (sg.)	Familienmitglied; Mitglied von ...
Angeklagter (sg.)	angeklagte Person
Angesprochener	angesprochene Person; kontaktierte Person; lyrisches Du [Kontext Lyrikanalyse]
Angler (sg.)	angelnde Person; Fisch fangende Person; Angelsport betreibende Person; Mensch mit Angel; wer gern angelt, ... ; Person, die angelt; Angelmensch
Angler (pl.)	Angelnde
Angreifer (sg.)	angreifende Person
Angreifer (pl.)	Angreifende
Anhänger (pl.)	Fans; Begeisterte; Gleichgesinnte; Unterstützende; Sympathisierende; sich (einer Bewegung, einem Verein) Zuordnende; Zugehörige (einer Bewegung); Mitwirkende; Befürwortende
Anhängerschaft	Gefolgschaft
Animateur	Freizeitbetreuungsperson
... Sprachanimateur	... zum Sprechen animierende/anregende Person
Animateure	Animierende
... Sprachanimateure	... Sprachanimierende
... Stimmungsanimateure	... Stimmungsunterhaltende
Ankläger	anklagende Person; Person, die Anklage erhebt; Person, die anklagt
Anleger (pl.)	Anlegende
Anleiter	anleitende Person; Anleitung
Anlieger (sg.)	anwohnende Person
Anlieger (pl.)	Anliegende; anwohnende Personen; Anwohnende
Anordner	Anordnung, anordnende Person
Anrainer	Person nebenan; Person, die nebenan wohnt; Person, der das Grundstück nebenan gehört
Anrufer (pl.)	Anrufende
Ansprechpartner (sg.)	Ansprechperson; (persönlicher) Kontakt; Kontaktperson; Auskunft gibt ... ; zuständig ist ... ; Hotline; Hilfeteam; Service; Servicepersonal
Antagonist	widerstreitende Person; Counterpart; Konkurrenz; gegenhandelnde Person
Anteilseigner (pl.)	Anteilsinhabende
Antisemit	antisemitisch eingestellte Person
Antragsgegner	dem Antrag entgegentretende Person; Gegenpart des Antrages
Antragsteller (sg.)	beantragende Person/Einrichtung; die Person, die einen Antrag stellt; die antragstellende Person; Antrag gestellt von ...
... Antragsteller werden in Kürze benachrichtigt.	... Sie werden kurz nach Antragstellung benachrichtigt.
Anwalt	Rechtsvertretung; gesetzliche Vertretung in Rechtsangelegenheiten; Mitglied der Anwaltschaft
Anwaltskosten	Kosten für die Rechtsvertretung
Anwärter	Person im Vorbereitungsdienst
Anwender (sg.)	anwendende Person; 
Anwender (pl.)	Nutzende; Anwendende; Personen, die ... anwenden; Anwendung
anwenderbezogen	anwendungsbezogen; praxisbezogen; verwendungsbezogen; menschbezogen
Anwenderfreundlichkeit	Verwendungsfreundlichkeit
Anwohner (pl.)	alle, die in dieser Straße wohnen; Anwohnende; Nachbarschaft
Apotheker (pl.)	(approbierte) Arzneikundige; approbierte pharmazeutische Fachkräfte
... Fragen Sie Ihren Arzt oder Apotheker.	... Holen Sie sich ärztlichen oder pharmazeutischen Rat. / Holen Sie sich bei Fragen ärztlichen Rat oder erkundigen Sie sich in Ihrer Apotheke.
Arbeiter (sg.)	Arbeitskraft
Arbeiter (pl.)	Erwerbstätige; Belegschaft; Beschäftigte; Arbeitskräfte
Arbeiterklasse	arbeitende Klasse
Arbeitgeber (sg.)	Führungskraft; arbeitgebendes Unternehmen; Person, die Arbeitsplätze zur Verfügung stellt; [im Arbeitsvertrag konkret:] Firma, Unternehmen, Gesellschaft,Genossenschaft, Einrichtung, Institution, Amt, Behörde; Arbeitsstelle ...
Arbeitgeber (pl.)	Arbeitgebende; Betriebe; Unternehmen
Arbeitgeberattraktivität	Arbeitsplatzattraktivität
Arbeitgebermarke	Unternehmensmarke; Employer Branding
Arbeitgebermarketing	Marketing für Arbeitgebende
Arbeitgebervorteile	Firmenvorteile; Unternehmensvorteile
Arbeitnehmer (sg.)	angestellte Person; beschäftigte Person
Arbeitnehmer (pl.)	Beschäftigte; Arbeitskräfte; Belegschaft; Personal; Erwerbstätige
Arbeitnehmervertreter	Arbeitnehmendenvertretung; Betriebsrat; Personalrat; Beschäftigtenvertretung
Arbeitsdirektor	Arbeitsdirektion
Arbeitskollegen	Teammitglieder
Archäologen	in der Archäologie tätige Person
Architekt	Architekturschaffende Person; Baukunstgestaltende Person
Architekten	Architekturschaffende
Archivar	Fachkraft für Archivwesen
Archivare	Archivierende
Arzt	Person im ärztlichen Dienst; ärztliches Fachpersonal
Arztausweis	ärztlicher Ausweis
Ärzte	ärztliches (Fach-)Personal; (ggf. Ärzteschaft)
... Anmeldung beim Schul-, Haus- oder Kinderarzt ... privat- oder schulärztliche Anmeldung
... Hilfe eines Arztes	... ärztliche Hilfe
... Fragen Sie Ihren Arzt oder Apotheker.	... Holen Sie sich ärztlichen oder pharmazeutischen Rat. / Holen Sie sich bei Fragen ärztlichen Rat oder erkundigen Sie sich in Ihrer Apotheke.
... Rat des Arztes	... ärztlicher Rat
Arztbesuch	ärztlicher Kontakt; ärztliche Sprechstunde; Besuch der ärztlichen Sprechstunde; ärztliche Visite
Entlassungsbrief; Entlassbericht; ärztlicher/medizinischer (Abschluss-)Bericht; ärztliche Epikrise; ärztlicher Brief; (ärztlicher) Befundbericht; ärztliches
Arztbrief	Informationsschreiben; ärztliche Information
Arztgeheimnis	ärztliche Schweigepflicht
Arzthelferinnen	Medizinische Fachangestellte; medizinsches Fachpersonal
Arztkoffer /-köfferchen	Behandlungstasche; Medizinkoffer /-köfferchen
Arztkosten	(ärztliche) Behandlungskosten; Kosten für medizinische Leistungen
Arzt-Patienten-Kommunikation	Kommunikation zwischen behandelnder und behandelter Person; behandlungsbezogene Kommunikation
Arzt-Patienten-Verhältnis	ärztliches Vertrauensverhältnis; medizinisches Behandlungsverhältnis
Arztpraxis	Praxis für ...-medizin (z.B. Praxis für Allgemeinmedizin); ärztliche Praxis
Arzttermin	Behandlungstermin; Vorsorgetermin; ärztlicher Termin
Arztwahl	Wahl des ärztlichen Fachpersonals
Arztzeugnis	ärztliches Zeugnis
Arztzimmer	Behandlungszimmer; Konsultationszimmer; Sprechzimmer; Zimmer/Raum; Büro Ärztliches Personal
Asket	asketisch lebende Person
Aspirant	bewerbende Person
Assessor	sachverständige Person; taxierende Person; einschätzende Person; schadensachverständige Person
Assessoren	Sachverständige; Taxierende; Einschätzende; Schadensachverständige
Assistent	Assistenz
Assistenzarzt	Person in fachärztlicher Weiterbildung; ärztliches Fachpersonal in Weiterbildung
Astronaut	ins Weltall reisende Person
Astronauten	Weltraumreisende; Menschen im All
Asylbewerber (pl.)	Asylsuchende; Personen im Asylverfahren
Atheist	atheistische Person; religionsfreie Person; nichtgläubige Person; irreligiöse Person; glaubenslose Person; areligiöse Person
Athlet	sporttreibende Person; 
Athleten	Sporttreibende; Wettkämpfende; 
Attentäter (sg.)	Person, die ein Attentat verübt
Auditor	auditdurchführende Person
Auftraggeber (pl.)	Auftraggebende; auftraggebende Personen; in Auftrag gegeben von ...
Auftragnehmer (sg.)	einen Auftrag entgegennehmende / annehmende Person
Auftragnehmer (pl.)	Auftragnehmende
Augenoptiker (Geschäft mit Werkstatt)	Optikfachgeschäft
Augenzeuge	beobachtende Person
Augenzeugen	Beobachtende
Aupairmädchen	Aupair
Ausbilder (sg.)	ausbildender Betrieb; Lehrkraft
Ausbildungsbewerber (sg.)	eine Ausbildung suchende Person
Ausländer (sg.)	Person aus dem Ausland; Person nichtdeutscher Herkunft; ausländische Person; Person mit anderer Staatsangehörigkeit
Ausländerbehörde	Migrationsamt/-stelle; Zuwanderungsamt/-stelle
Außenseiter (pl.)	Randständige
Aussiedler (sg.)	ausgesiedelte Person
Aussiedler (pl.)	ausgesiedelte Personen
Ausstatter	ausstattende Person
Aussteiger [aus einer Szene]	[aus einer Szene] aussteigende Person
Aussteller (sg.)	ausstellende Person; ausstellende Institution
Aussteller (pl.)	Präsentierende; Ausstellende
Ausstellerausweis	Ausweis der Ausstellenden; Ausweis der ausstellenden Person
Ausstellerliste	Liste der Ausstellenden; Ausstellendenliste
Auswanderer (sg.)	auswandernde Person; ausgewanderte Person
Auswanderer (pl.)	Auswandernde; Ausgewanderte
Ausweisinhaber	Ausweis inhabende Person
Auszubildender (sg.)	Nachwuchskraft; Person in Ausbildung; auszubildende Person; lernende Person
Auszubildende (pl.)	[im Plural ist dieses Wort schon gendergerecht]
Autofahrer (sg.)	Auto fahrende Person; Auto führende Person; Person am Steuer
Autofahrer (pl.)	Autofahrende; Personen am Steuer
Autohersteller (pl.)	Automobilkonzerne; Autoherstellende; Autobauende
Autor	bücherschreibende Person
Autorenschaft; Urheberrechtsinhabende; Verfassende; Schreibende; Literaturschaffende; wissenschaftlich Publizierende;
Autoren	Auktorierende Erläuterung eines Users: 'Autor' kommt von lat. 'Auktor' und meinte historisch v.a. den sozialen Akt des Verbürgens gegenüber Individuen oder einem
Kollektiv. Spricht man von 'Schreibenden', fehlt der Aspekt des Sprechakts des Schreibens bzw. Veröffentlichens.
Azubi	Nachwuchskraft; Person in Ausbildung; auszubildende Person; lernende Person
Babysitter (sg.)	Aufsichtsperson; babysittende Person; Kinderbetreuung
Babysitter (pl.)	Babysittende
Bachelor of ...	B.A. / B. Sc. / ...
... Sie ist Bachelor of Arts in Geschichte.	... Sie hat den Bachelor of Arts in Geschichte.
Bachelorand	studentische Stelle zur Anfertigung der Bachelorarbeit
Bäcker (sg.)	Backwaren produzierende Person; Gebäck herstellende Person; Bäckerei
Bäcker (pl.)	Backende; im Backgewerbe Tätige; professionell Backende
Bademeister	Badeaufsicht
Bankkaufmann	Bankkaufperson
Bankräuber (pl.)	Bankausraubende
Barkeeper	Bar-Servicekraft; Servicekraft (an) der Bar
Bauarbeiter	Bauarbeiten ausführendes (Fach-)Personal
Bauern	Landwirtschaft Betreibende; landwirtschaftlich Beschäftigte; Beschäftigte in der Landwirtschaft; bäuerliche Bevölkerung [historischer Kontext]
Bauernhof	landwirtschaftlicher Betrieb
Bauernkrieg	Krieg der landbewirtschaftenden Bevölkerung
Bauherr	den Bau in Auftrag gebende Person; Auftraggebende Person / Instanz
Bauherren	Bauverantwortliche; Bauleute; den Bau in Auftrag gebende Personen
... Angebot für private Bauherren	... Angebot für privat Bauende
Bauherrschaft; Bauvorhabensschaft	Bauleute; Auftraggebende
Bauingenieur	für die Baukonstruktion verantwortliche Person; für die Bauplanung verantwortliche Person
Baumpfleger	Baumpflege
Bauträger (sg.)	für den Bau verantwortliche Firma
Bauträger (pl.)	Bautragende; Bauverantwortliche
Beamter (sg.)	verbeamtete Person; Person im Beamtenstatus
Beamte (pl.)	Bedienstete; Beamtenschaft
Beamtenlaufbahn	verbeamteter Werdegang; Laufbahn im öffentlichen Dienst mit Aussicht auf Verbeamtung
Bearbeiter (sg.)	den Vorgang betreuende Person; zuständige Person
Beauftragter (sg.)	beauftragte Person
... Sicherheits- / Datenschutz- / ...-beauftragter	... beauftragte Person für Sicherheit / Datenschutz / ...
Bediener (sg.)	bedienende Person
... Bediener einer technischen Anlage	... eine technische Anlage bedienende Person
Bediensteter (sg.)	bedienstete Person
Befrager	befragende Person; Person, die befragt (hat)
Befragter	befragte Person; Person, die befragt wurde
Befürworter (sg.)	befürwortende Person; zustimmende Person; Zustimmung
Befürworter (pl.)	Unterstützung; Zustimmende; Mitwirkende; Befürwortende
Begleiter	Begleitung
Behinderter	Mensch mit Behinderung; Mensch mit Beeinträchtigung
Beisitzer (pl.)	Beisitzende
Bekannter	Person aus dem Bekanntenkreis; (mir) bekannte Person; Bekanntschaft
bemannt	besetzt; mit Personen besetzt; astronautisch
... Raumfahrt mit Besatzung;
... bemannte Raumfahrt
... astronautische Raumfahrt; kosmonautische Raumfahrt; taikonautische Raumfahrt	im Gegensatz zu robotischer Raumfahrt
bemuttern	fürsorglich sein; verhätscheln; umsorgen
Benutzer (sg.)	anwendende Person; nutzende Person
Benutzer (pl.)	Anwendende; Nutzende; Personen(-gruppen)
benutzerdefiniert	maßgeschneidert; speziell; passgenau; individuell einstellbar; spezifisch; selbstdefiniert
Benutzerentscheidung	individuelle Entscheidung; Einzelfallentscheidung; persönliche Einstellung
Benutzerfehler	Anwendungsfehler
benutzerfreundlich	praktisch / leicht zu bedienen; bedienungsfreundlich; benutzungsfreundlich
Benutzerfreundlichkeit	Nutzungsfreundlichkeit; Benutzungsfreundlichkeit; Anwendungskomfort; Anwendungsfreundlichkeit
Benutzerfunktion	zielgruppengerechte Funktion; nutzenorientierte Funktion
Benutzerkonto	Account; Konto; Zugang; Profil
Benutzername	Anmeldename; Nickname; Pseudonym; Login-Name; Login
Benutzeroberfläche	Bedienoberfläche; Benutzungsoberfläche
Benutzerordnung	(Be-)Nutzungsordnung
Benutzerportal	Benutzungsportal
Benutzerrechte	Benutzungsrechte
Benutzerschnittstelle	Interaktionsschnittstelle
Benutzerverwaltung	Kontoverwaltung; Zugangsverwaltung
Beobachter (pl.)	Beobachtende
Beobachtergruppe	Beobachtendengruppe
Berater (sg.)	beratende Person; die Beratung erfolgt durch ... ; Sie werden beraten von ...
Berater (pl.)	Beratende
Beratertätigkeit	beratende Tätigkeit; Beratung
Beraterverzeichnis	Verzeichnis beratender Personen
Berechtigter	berechtigte Person
Bergführer	bergführende Person; für Bergführung qualifizierte Person; eine Bergtour leitende Person
bergmännisch	im Bergbau tätig
... bergmännische Hohlräume	... Altbergbau
Bergsteiger (pl.)	Bergbegeisterte; Bergsteigende
Berichterstatter (sg.)	Bericht erstattende Person
Berichterstatter (pl.)	Berichtende
Berliner (pl.)	die Berliner Bevölkerung
Berufsanfänger (pl.)	Berufsunerfahrene; Berufseinsteigende
Berufskraftfahrer (sg.)	qualifizierte fahrzeugführende Person (nach BKrFQG)
Berufskraftfahrer (pl.)	Berufskraftfahrende Begriff wird z.B. von TÜV Nord offiziell benutzt
Berufsschüler (pl.)	Auszubildende; Beruflernende; eine Berufsschule Besuchende; an einer Berufsschule Lernende
Beschäftigter (sg.)	Arbeitskraft; beschäftigte Person; angestellte Person; Person im Beschäftigungsverhältnis
Beschäftigte (pl.)	[dieser Begriff ist im Plural bereits genderneutral]
Beschuldigter	beschuldigte Person
Beschwerdeführer (pl.)	Beschwerdeführende
Besitzer (sg.)	besitzhabende Person
Bestatter	Fachkraft für Bestattungen
Besitzer von Immobilieneigentum (sg.)	Immobilien besitzende Person
Besteller (sg.)	bestellende Person; Kundschaft
Besucher (pl.)	Publikum; Besuche; Besuchende
Besucheranschrift	Besuchsanschrift
Besuchergruppe	Besuchsgruppe
Besuchermagnet	Publikumsmagnet; Besuchsmagnet; Tourismusmagnet; Anziehungspunkt; Sehenswürdigkeit
Besucherparkplatz	Besuchsparkplatz
Besucherrückgang	sinkende Nachfrage; Rückgang der Besuche; … wurde weniger frequentiert als im Jahr zuvor …
Besucherstrom	Publikumsstrom
Besucherzahl	Besuchszahl; Frequentierung; Klickzahl; Interesse; Inanspruchnahme; Gästezahlen
Besucherzahlen	Besuchszahlen; Frequentierung; Klickzahlen; Interesse; verkaufte Tickets; Gästezahlen
Betrachter (pl.)	Betrachtende
Betreiber (sg.)	Betriebsgesellschaft; betreibende Firma; Betrieb
... Der Netzbetreiber fordert ...	... Von Seiten des Netzbetriebs wird ... gefordert.
Betreiber (pl.)	Betreibende
Betreuer (sg.)	Betreuungsperson
Betreuer (pl.)	Betreuungspersonal
Betriebsarzt	Betriebsärztlicher Dienst
Betriebsrat	Mitglied des Betriebsrates s. dazu auch FAQ Muss ich Betriebsrat gendern?
Betriebsräte	Mitglieder des Betriebsrates; der Betriebsrat; Mitarbeitendenvertretung; der Personalrat s. dazu auch FAQ Muss ich Betriebsrat gendern?
Betriebswirt	betriebswirtschaftende Person
Betroffener (sg.)	betroffene Person; Opfer
Betrüger (sg.)	unehrliche Person
Bevollmächtigter	bevollmächtigte Person
Bewahrer (sg.)	bewahrende Person
Bewerber (sg.)	sich bewerbende Person
Bewerber (pl.)	Bewerbende; sich bewerbende Personen
Bewerbermangel	Mangel an Bewerbungen; Mangel an Bewerbenden; mangelnde Bewerbungen
Bewerberzahlen	Bewerbungszahlen
Bewohner (pl.)	in ... Lebende; in ... lebende Menschen; Ortsansässige; Bewohnende; Bewohnerschaft
Bewohnerzimmer	Bewohnendenzimmer; Zimmer
Bezieher [von Leistungen] (pl.)	Beziehende
Bieter (sg.)	bietende Partei; bietende Person
Bildungsträger (pl.)	Bildungstragende
Biografieträger (pl.)	Biografietragende
Blindenführer	Guide für blinde Menschen; Blindenguide; Begleitung für blinde Menschen; Mobilitätshilfe
Blockwart	Gebietsaufsicht; Blockaufsicht
Blogger (pl.)	bloggende Personen; Personen, die einen Blog schreiben
Blumenmädchen	Blumenkind
Bogenschütze	Bogenschießende Person
Bote	Botschaft überbringende Person
Botschafter	Spitze des Diplomatischen Corps; Repräsentanz
Brandschutzbeauftragter	beauftragte Person für Brandschutz
Brautpaar	Hochzeitspaar; verlobtes Paar
Briefträger	Briefzustellung; Postzustellung
Brillenträger	Personen mit Brille
Bruder / Schwester	Geschwister, das; Geschwisterkind
... Wie alt ist dein Bruder / deine Schwester?	... Wie alt ist dein Geschwister(kind)?
Brüder und Schwestern	Geschwister; Geschwisterkinder
Brüderlichkeit	Mitmenschlichkeit; Solidarität; Geschwisterlichkeit
Buhmann	Feindbild; schuldige Person; Zielscheibe; (Sündenbock)
Buddhisten	Menschen buddhistischen Glaubens
Bundeskanzler	(oberste) Führungskraft der Bundesregierung; Leitung der Bundesregierung; erste Führungsperson der Bundesregierung
Bundespräsident	deutsches Staatsoberhaupt; Staatsoberhaupt einer Bundesrepublik; Person, die die Bundespräsidentschaft inne hat
Bundespräsidentenwahl	Bundespräsidentschaftswahl; BP-Wahl
Bundestagspräsident	Bundestagsvorsitz
Bürge	bürgende Person
Bürger (sg.)	Mitglied des Staates / der Stadt; dem Staat zugehörige Person; Mitmensch; rat-/hilfe-/unterstützungssuchende Person [im Verwaltungskontext]; Individuum;Einzelperson; einzelner Mensch innerhalb der Bevölkerung; bürgerliche Person [historischer Kontext]
Bürger (pl.)	Bevölkerung; Einwohnerschaft; (Kommunal-)Wahlberechtigte; Staatsangehörige; Einheimische; im Ort/in der Stadt ... Wohnende; Stimmberechtigte; allgemeine Öffentlichkeit; breites Publikum; bürgerliche Bevölkerung; Bürgerschaft; Bürgertum
Bürgeramt	Amt; Gemeindeamt; Verwaltung
Bürgerbeteiligung	Direkte Demokratie; Beteiligung der Bevölkerung; Öffentlickeitsbeteiligung
Bürgerbüro	(städtisches/kommunales) Service Center/Servicebüro; Stadtteilbüro; Stadtbüro; Nachbarschaftbüro; Gemeindebüro; Kommunalbüro; Informationsbüro (für Anwohnende); Büro für bürgerliche Belange; Informationsstelle (für Ratsuchende)
Bürgerhaus	Gemeindehaus; Stadthaus; Kulturzentrum; Stadtteilzentrum; selbstverwaltetes Zentrum
Bürgerkrieg	Volkskrieg; innerer Krieg/Konflikt
Bürgermeister (sg.)	Stadtoberhaupt; Verwaltungsleitung; Oberhaupt einer Kommune
Bürgermeisterkandidat	Kandidatur für das Amt des Stadtoberhaupts
bürgernah	serviceorientiert; bedürfnisorientiert; publikumsorientiert; menschenorientiert; im Kontakt
... bürgernahe Verwaltung	... serviceorientierte Verwaltung; menschenorientierte Verwaltung; Verwaltung im Kontakt mit den Menschen; Verwaltung auf Augenhöhe
Bürgernähe	Volksnähe; Bevölkerungsnähe
Bürgerrat	Volksrat; Menschenrat; Bewohnendenrat; bürgerlicher Rat; Bevölkerungsrat
Bürgerrechte	Rechte des deutschen (oder anderer Staaten) Staatsvolkes
Bürgersteig	Gehweg; Fußweg
Bürgervertretung	Vertretung der Öffentlichkeit
Bürgerwissenschaft	Citizen Science;
Bürgerzentrum	Kulturzentrum; Stadtteilzentrum; selbstverwaltetes Zentrum
Bürokrat	bürokratische Person; bürokratisch veranlagte Person
Busfahrer (sg.)	Busführung; busführende Person; Busfahrpersonal; Buspersonal
Callcenter Agent	telefonische Beratung der Kundschaft
Callcenteroperator	Callcenteroperierende Person
Callcenteroperatoren (pl.)	Callcenteroperierende
Camper (sg.)	campende Person; zeltende Person; Zeltplatzmensch; Camping liebende Person
Case-Manager (pl.)	Case-Management; Case-Managende
Chauffeur	Fahrdienst
Chef	vorgesetzte Person; Leitungsperson; Leitung; Kopf (eines Unternehmens / einer Abteilung); Führungskraft
Chefs	Vorgesetzte; Leitung
Chefarzt	Ärztliche Leitung; Ärztliche Klinikleitung
Chefarztbehandlung	chefärztliche Behandlung
Chefsache	Sache mit oberster Priorität; Angelegenheit mit besonderer Wichtigkeit; dringliche Sache
Chemiker (sg.)	Fachkraft für Chemie
Chirurg	chirurgische Fachkraft; chirurgische Fachperson; ärztliche Fachkraft der ...-Chirurgie
Chirurgen	chirurgisches Fachpersonal
Chirurgenstahl	Chirurgiestahl
Christen	Menschen christlichen Glaubens
Chorleiter (sg.)	Chorleitung
Chorleiter (pl.)	Chorleitende; Chorleitungen
Coach	Begleitung; Beratung; coachende Person
Coder	codende Person
Cousins	Geschwister 2. Grades
Cyber-Erpresser	Cyber-Erpressung
... Gewappnet sein gegen Cyper-Erpresser	... Gewappnet sein gegen Cyper-Erpressung
Dahergelaufener (bayrisch)	dahergelaufende Person
Damenfahrrad	Trapezrahmenfahrrad; Fahrrad mit tiefem Einstieg
damenhaft	fein
Damenprogramm	Begleitprogramm
Darsteller (sg.)	darstellende Person
... Kinderdarsteller (sg.)	... darstellende Person im Kindesalter; ... schauspielendes/darstellendes Kind
Darsteller (pl.)	Rollen; Besetzung; Darstellende
... Kinderdarsteller (pl.)	... Darstellende kindlichen Alters
Datenschutzbeauftragter	Fachperson für Datenschutz; Datenschutzverantwortlichkeit
Dekan	Leitung des Dekanats; Dekanat
Delegierter	delegierte Person
Demokraten	Demokratiebegeisterte; Demokratieüberzeugte; demokratisch eingestellte Personen
Demonstranten	Demonstrierende
derjenige, der...	diejenige Person, die ... ; die Person, die ...
Designer (pl.)	Designschaffende
Detektiv	(privat) ermittelnde Person; privat ermittelnde Person; nach Hinweisen suchende Person
Deutscher (sg.)	Person aus Deutschland; deutsche Person; Person mit deutscher Staatsangehörigkeit
Developer	Developing Person; Developing Employee
Dezernent	Dezernat leitende Person; Dezernatsleitung
Diabetiker	Mensch mit Diabetes; Diabetes erkrankte Person
Dichter	dichtende Person; poetische Person
Dieb	Eigentum entwendende Person; Langfinger
Diebe	Kriminelle; Langfinger
Dienstherr	Dienstaufsichtsperson; Dienstbehörde
Dienstherrengenehmigung	Genehmigung der vorgesetzten Führungskraft; Dienststellengenehmigung; behördliche Genehmigung
Dienstleister (sg.)	dienstleistende Person; dienstleistendes Unternehmen; Dienstleistungsunternehmen
Dienstleister (pl.)	Dienstleistende
Diplomat	Person im diplomatischen Dienst
Diplomingenieur	diplomierte technische Fachkraft
Direktor	Leitung [z.B. Schulleitung; Institutsleitung; Museumsleitung]
Dirigent	unter dem Dirigat von ...; unter Leitung von ...
Disponent	Disposition
DJ (sg.)	der/die DJ
Doktoranden	Promovierende
Doktorandenkolleg	Promotionskolleg; Promovierendenkolleg
Doktorarbeit	Promotion
Doktorvater/-mutter	Promotionsbetreuung; Vorsitz des Promotionskomitees
... Wer ist Ihr Doktorvater?	... Wer betreut Ihre Promotion? / ... Wer hat die Betreuung Ihrer Promotion inne?
Dokumenteninhaber	im Besitz von Dokumenten
Dolmetscher (sg.)	(simultan / konsekutiv) dolmetschende Fachkraft
Dönermann	Dönerimbiss; Dönerverkauf; Kebapverkauf; Dönerfachgeschäft; Dönerbude
Doppelgänger (sg.)	Double; Ebenbild; Doppelperson
Dozent	lehrende Person; Lehrkraft; Lehrperson; vortragende Person; Seminarleitung
Dozenten	Dozierende; Lehrpersonal; Lehrende
Dozententätigkeit	Lehrtätigkeit
Drachenlord	herrschende Drachenperson
Dritter	dritte Person
Drittanbieter (sg.)	Drittanbietende; externe Unternehmen
Editor	herausgebende Person
Ehegatte	die Ehe teilende Person; Ehemensch; Eheherzperson; Herzmensch; Herzensmensch
Ehegatten	Eheleute
Ehepartner (sg.)	geehelichte Person; Ehemensch
Ehrenamtler (pl.)	Ehrenamtliche; Freiwillige; (ehrenamtlich) Engagierte
Ehrenmann	Ehrenperson
Eigentümer	(im) Eigentum von ...
... Immobilien- / Hauseigentümer (sg.)	... Eigentumspartei; das Eigentum am Haus innehabende Person
... Immobilien- / Hauseigentümer (pl.)	... Vermietende;
Eigentümerversammlung	Versammlung der Beteiligten am Wohneigentum; Versammlung der Besitzenden
Eigner	s. Eigentümer
Einbrecher (pl.)	einbrechende Personen
Einflussnehmer (sg.)	Einfluss nehmende Person; Person, die Einfluss nimmt
Einflussnehmer (pl.)	Einflussnehmende
Einkäufer	einkaufende Person
Einlader	einladende Person
Ein-Mann-Betrieb	Ein-Personen-Betrieb
einer nach dem anderen	der Reihe nach
einem selbst	dir selbst
Einsteigerkurs	Einstiegskurs; Grundlagenkurs; Grundkurs; Basiskurs
Einwanderer (pl.)	Menschen mit Migrationshintergrund /-geschichte /-biografie; Menschen mit internationaler Geschichte
Einwandererfamilien	Familien mit Migrationshintergrund /-geschichte; Familien mit internationaler Geschichte
Einwohner (pl.)	die Menschen der Stadt XY; Population; Bevölkerung; gemeldete Personen
... 2000 Einwohner/km2	... 2000 gemeldete Personen/km2
Einwohnerdichte	Bevölkerungsdichte
Einwohnerzahl	Bevölkerungszahl; Anzahl der Einwohnenden
Einzelgänger	alleinliebende Person
Einzelhändler	Person des Einzelhandels; Betrieb im Einzelhandel; im Einzelhandel tätige Person
Einzelkämpfer (pl.)	Einzelkämpfende; Kriegsteilnehmende
Einzelner	alle; die einzelne Person
... jeder Einzelne	... alle; jede einzelne Person
Einzelne	[im Plural ist dieses Wort schon gendergerecht]
Einziger	einzige Person
Elektriker	Fachkraft für Elektrotechnik
Elektroniker (sg.)	Elektrofachkraft
Elektrotechniker	Fachkraft für elektrotechnische Anlagen
Elternzeitrückkehrer (pl.)	Mitarbeitende, die aus der Elternzeit zurück kommen; Elternzeitrückkehrende; Beschäftigte nach der Elternzeit
Emittent	Wertpapierherausgebende Person
Empfänger (sg.)	empfangsberechtigte Person; empfangen von ... ; für ... ; bestimmt für ...
Empfangsdame	Empfang; Person/Personal am Empfang; Rezeption
Endverbraucher (pl.)	Endverbrauchende; Endkonsumierende
Energieversorger	Energieversorgungsunternehmen
Enkel (sg.)	Enkelkind; Kindeskind
Entdecker (sg.)	entdeckt von ...
Entdecker (pl.)	entdeckt von ... ; entdeckende Personen /Kinder; Forschende; Entdeckende
Enthusiast	enthusiastische Person; begeisterte Person
Enthusiasten	Begeisterte
Entscheider (sg.)	Entscheidung fällende Person; entscheidungsbefugte Person
Entscheidungsträger (sg.)	Person mit Entscheidungsbefugnis
Entscheidungsträger (pl.)	Entscheidungtragende
... politische Entscheidungsträger	... politische Entscheidungstragende
Entwickler (pl.)	Entwicklungsteam; Entwickelnde; Erfindende; Ideenfindende; Entwicklungsabteilung
Erbauer (pl.)	Konstruierende; Erschaffende; erbaut von ...; ein Bau von ...
Erbe	erbberechtigte Person
Erben	Erbberechtigte
Erblasser	vererbende Person; Erbe hinterlassende Person
Erfinder	erfindende Person; ideenfindende Person
Erfüllungsgehilfe	bei der Erfüllung behilfliche Person
Ergotherapeut	in der Ergotherapie tätige Person
Erkrankter	erkrankte Person
Ermittler (pl.)	Ermittelnde; Ermittlungsteam
Errichter	errichtet von ...
Ersteller	erstellt von ...
Ersthelfer (sg.)	erste Hilfe leistende Person; in Erster Hilfe geschulte Person
Ersthelfer (pl.)	Ersthelfende
Erstsemester (pl.)	Studierende im ersten Semester; Ersti
Erwachsener	erwachsene Person
Erwachsene (pl.)	[dieser Begriff ist im Plural bereits genderneutral]
Erzähler (sg.)	erzählende Figur; erzählende Person; Erzählinstanz
Erzähler (pl.)	Erzählende
Erzeuger	ein Produkt erzeugende Person
... landwirtschaftliche Erzeuger	... landwirtschaftlich (Produkt-)Erzeugende; Produzierende von landwirtschaftlichen Produkten
Erzieher (sg.)	pädagogische Fachkraft; Erziehungskraft
Erziehungsberechtigter	erziehungsberechtigte Person
Erziehungsberechtigte	[im Plural ist dieses Wort schon gendergerecht]
Ethnologe	Person mit Fachwissen in Ethnologie; Person mit ethnologischer Expertise
EU-Kommissar	EU-Kommissionsmitglied
Evakuierungshelfer (sg.)	Evakuierungshilfe; in Evakuierungshilfe geschulte Person; Evakuierungshilfe leistende Person
Evaluator	auswertende / beurteilende / bewertende / Gutachten gebende / evaluierende Person
Exot [z.B. innerhalb eines Faches]	Ausnahmeerscheinung
Experte (sg.)	Fachgröße; Autorität; Koryphäe; Person vom Fach; Genie
Experten (pl.)	Fachkräfte; Fachleute; Fachpersonen; Fachkundige; Sachverständige
Expertengruppe	Fachgruppe; Arbeitsgruppe
Experteninterview	Expertiseinterview; Interview mit Fachleuten
Expertenkommission	Fachkommission; Kommission von Fachleuten
Expertenrating	Rating von Fachleuten
Expertenschätzung	Schätzung von Fachleuten; nach Einschätzung von Fachleuten; Expertise
Expertenstandard	Fachstandard
Expertentagung	Fachtagung
Expertentum	Expertise
Expertenvortrag	Fachvortrag
Expertenwissen	Fachwissen; Expertise
Extremist	radikalisierte Person
Facharbeiter (pl.)	Facharbeitende
Facharzt	(fach-)ärztliche Fachkraft; Fachpraxis
Facharztrichtung	medizinische Fachrichtung
... Ärzte aus verschiedenen Facharztrichtungen	... Ärztinnen und Ärzte aus verschiedenen Fachrichtungen
Fachberater	Fachberatung
(Informatikfachkraft) eher nicht zu empfehlen, denn die Bezeichnung Fachinformatiker ist ein staatlich anerkannter Ausbildungsberuf; Informatikfachkraft ein
Fachinformatiker	Sammelbegriff für Menschen in der IT, auch ohne Ausbildung.
Fachmann	Fachkraft
... Rat eines Fachmannes	... fachkundiger Rat; fachlicher Rat
fachmännisch	fachkundig; professionell; fachlich
Fachwissenschaftler (pl.)	Fachforschende
Fahrer (sg.)	Fahrdienst; Person des Wagens XX
Fahrer (pl.)	Fahrzeugführende; Fahrende; Fahrdienst
Fahrerhaus	Cockpit
Fahrerkabine	Fahrkabine; Steuerungskabine
Fahrersitz	Cockpitsitz; Sitz der fahrenden Person
Fahrgast	mitreisende Person; gegen Entgelt transportierte Person
Fahrgäste	Mitfahrende; Reisende
Fahrgastraum	Abteil; Personenbeförderungsräume
Fahrradfahrer (pl.)	Fahrrad Fahrende; wer mit dem Fahrrad unterwegs ist ...
... Fahrradfahrer müssen absteigen.	... Fahrräder bitte nur schieben.
Fahrschüler (pl.)	Fahrlernende
Fahrschullehrer	Fahrschullehrkraft
Fahrzeugführer	fahrzeugführende Person; Fahrzeugführung
Fahrzeuglenker (sg.)	Fahrzeug lenkende Person
Familienbegleiter (sg.)	Familienbegleitung; Familien begleitende (Fach-)Kraft
Familienhelfer (sg.)	Familienhilfe; Familien unterstützende (Fach-)Kraft; die die Familie X. unterstützende Fachperson/Fachkraft
Fan	in besonderem Maße begeisterte Person
Fans	Begeisterte
... Basketballfans	... Basketballbegeisterte
Faschist	dem Faschismus anhängende Person
Fasnächtler (pl.)	Fasnachtbegeisterte
Favorit [nur bei Personen]	favorisierte (antretende) Person; favorisierte Option; bevorzugte Person; Liebling
Feigling	feige Person; Angsthase
Feind	verfeindete Person
Feinschmecker	Genussmensch
Feministin	feministische / feministisch eingestellte Person
Fertiger (sg.)	fertigende Person
Fetischist	Person mit einem Fetisch
Feuerwehrmänner	Einsatzkräfte der Feuerwehr; Feuerwehrangehörige; Feuerwehr; Feuerwehrleute; Feuerbekämpfende
Filmemacher (sg.)	filmschaffende Person
Filmemacher (pl.)	Filmschaffende
Filmstar	Filmgröße; Filmberühmtheit
Finalist	am Finale teilnehmende Person
Finalisten	am Finale Teilnehmende
Finanzbeauftragter	finanzbeauftragte Person
Finanzintermediäre	Anbietende von Finanzintermediation; Finanzintermediierende
Fischer	Fisch fangende Person
Flüchtlinge (pl.)	Geflüchtete; Flüchtende; geflüchtete Menschen
FÖJler (pl.)	FÖJ-Freiwillige
Follower (pl.)	Follis; Follows
Förderer (sg.)	Stelle, die Fördermittel vergibt; Person, die Fördermittel vergibt; fördernde Person
Förderer (pl.)	unterstützender Personenkreis
Fördermittelgeber	Stelle, die Fördermittel vergibt; fördermittelgebende Stelle/Institution
Forscher (pl.)	Forschende; Universitätsmitglieder; wissenschaftliches Personal der Universität; Menschen, die in der Forschung tätig sind; Forschungsteam
Forschergemeinde	Forschungsgemeinde
Forscherkolloquium	Forschungskolloquium
Forscherteam	Forschungsteam
Förster (pl.)	Beschäftigte in der Forstwirtschaft
Forstwart	Forstaufsicht
Fotograf	fotografierende Person; (Berufs-)Fotografie betreibende Person
Fotografen	Fotografierende; Aufnehmende
Fotografenteam	Fototeam; Fotografieteam
Fragensteller	fragende Person
Freelancer (pl.)	Freischaffende; Selbstständige;
Freiberufler (sg.)	freiberuflich arbeitende Person; freischaffende Person
Freigeber (sg.)	freigebende Person
Freiwilliger	freiwillige Person
Fremdsprachler	andere / fremde Sprache sprechende Person
Freund	(enge) Bezugsperson; Herzensmensch; Bekanntschaft; Lieblingsmensch; bessere Hälfte
... Hast du einen Freund?	... Bist du vergeben? Lebst du in einer Beziehung?
... Sasha ist meine Freundin.	... Ich bin mit Sasha zusammen. / Sasha ist mein Lieblingsmensch/meine bessere Hälfte. / Sasha ist die Person, die ich liebe.
Freunde (pl.)	Bekannte; Bezugspersonen; befreundete Personen
Freundeskreis	Personen in befreundeten Kreisen; peergroup; Bezugsgruppe
Friseur	frisierende Person; Frisiersalon
... Ich gehe heute zum Friseur.	... Ich gehe heute in den Frisiersalon. / Ich gehe heute zum Haare schneiden.
Friseure	Frisierende
Friseurtermin	Haarschneidetermin; Frisiertermin
Frühaufsteher (sg.)	Morgenmensch; Lerche
Frühbucherrabatt	Frühbuchungsrabatt
FSJler (pl.)	FSJ-Freiwillige
Führerschein	Fahrerlaubnis; Fahrberechtigung
Funktionär	in Funktion gewählte Person; verantwortliche/beauftragte/bevollmächtigte Person; Vollmachtsperson
Funktionsträger (sg.)	in Funktion gewählte Person; verantwortliche/beauftragte/bevollmächtigte Person
Fürsprecher (sg.)	Unterstützung; Unterstützungskraft; Support
Fürsprecher (pl.)	Mitwirkende; Beteiligte; Befürwortende; Support; Supportende; Fürsprechende
Fußballspieler (pl.)	Fußballspielende
Fußgänger (pl.)	Menschen zu Fuß; zu Fuß Gehende; Fußverkehr
Fußgängerampel	Ampel; Personenampel
Fußgängerstreifen	Zebrastreifen; Straßenpassierstreifen
Fußgängerüberweg	Überquerung
Fußgängerweg	Gehweg
Fußgängerzone	Flanierzone; Einkaufsstraße; Einkaufszone; verkehrsfreie Zone;
Gaffer (pl.)	Schaulustige
Gamechanger	Wendepunkt; Paradigmenwechsel
Gamer (pl.)	Gaming People
Gärtner	Gartenarbeitskraft
Gärtnerei	Gartenbaubetrieb
Gast	Besuch; Besuchsperson
Gastbeitrag	Sonderbeitrag
Gastfreundschaft	Gastlichkeit
Gäste	Eingeladene; Geladene; Besuche Ich bin mir unsicher, ob 'Gäste' im Plural nicht schon gendergerecht ist, analog zum Wort 'Menschen'. Im Duden ist der feminine Plural 'Gästinnen' allerdings zu finden.
Gästeführer	Reiseführung; Reiseleitung; (Tourguide)
Gastgeber (sg.)	einladende Person
Gastgeber (pl.)	Einladende
Gasthörer (pl.)	Studierende im Gaststudium
Gasthörerstatus	Gaststudierendenstatus; Gasthörstatus
Gasthörerstudium	Gaststudium; Hospitation
Gastronomen	Betreibende eines Gastronomiebetriebs
Gastwirt	Gastronomiebetriebsleitung
Gastwirte	Betreibende eines Gastronomiebetriebs
Gastwissenschaftler (pl.)	Gastforschende
Gatte	Heiratsperson
Gefreiter	Person mit zweitniedrigstem militärischen Mannschaftsdienstgrad
Gegenkandidat	Gegenkandidatur
Gegenspieler (sg.)	gegnerische Partei; widerstreitende Person; Counterpart; Konkurrenz
Gegenspieler (pl.)	gegnerische Partei; gegnerische Spielende; feindliche Spielende; Gegenseite; Konkurrenz
Gegner (sg.)	gegnerische Partei; widerstreitende Person; Counterpart; Konkurrenz; ablehnende Person
Gegner (pl.)	gegnerische Partei; gegnerische Spielende; feindliche Spielende; Gegenseite; Konkurrenz
Geisterfahrer	Fahrzeug in falscher Richtung; Geisterfahrzeug
Geldgeber (pl.)	Geldgebende; support; geldgebende Institution
Gelehrter	gelehrte Person
Generaldirektor	Direktoriumsleitung
Generalist	Universalgenie; Multitalent; fachlich breit aufgestellter Mensch
General Manager [Systemgastronomie, Hotellerie]	Verantwortungsperson im General Management
Genießer	Genussmensch
... Wanderung für Genießer	... Wanderung für Genussmenschen; ... Genusswanderung
Genosse	Mitglied der Genossenschaft
Genossenschaft	[ich bin mir unsicher, ob das Wort gendernswert ist oder nicht; analog Kundschaft, Freundschaft, …]
Gentlemen's Agreement	mündliche Vereinbarung; Vereinbarung per Handschlag; Absprache unter Ehrenleuten
Geograph	Person mit Fachwissen in Geographie; Mensch mit fundiertem Wissen über Geographie
Geologe	Person mit Fachwissen in Geologie; Mensch mit fundiertem Wissen über Geologie
Geologen	Forschende der Geologie
Gerätewart	Geräteaufsicht
Gerichtsvollzieher	Gerichtsvollzugsperson
Gerüstbauer	Fachkraft für Gerüstbauer
Geschäftsführer (sg.)	Geschäftsführung; Geschäftsleitung
Geschäftsmänner	Geschäftsleute
Geschäftspartner	geschäftliche Verbindung; geschäftlicher Kontakt
Geselle [im Handwerk]	neu ausgelernte Fachkraft
Gesellschafter [teilhabende Einzelperson]	im Besitz von Geschäftsanteilen stehende Person; Person mit Geschäftsanteilen
Gesellschafter (pl.)	Betriebsgesellschaft; Beteiligte; Gesellschaftende
Gesetzgeber	Legislative; gesetzgebende Instanz; Gesetzgebende
Gesprächspartner (sg.)	Gegenüber
Gesprächspartner (pl.)	Gesprächsbeteiligte; Gegenüber
Gesprächsteilnehmer (pl.)	Gesprächsbeteiligte
Gestalter (pl.)	Gestaltende
Gewinner (sg./pl.)	Erster Platz
Gläubiger (pl.)	Geld-/Kreditgebende
Globetrotter (pl.)	Weltreisende
Götter	Allwissende; Allmächtige; übernatürliche Wesen; Ewige; Gottheiten
Grafiker	Grafikprofi; Grafikfachperson; Person mit Grafikfachkenntnissen
Grenzgänger (pl.)	Grenzpendelnde
Grinsepeter	Grinsebacke; Grinsegesicht; Grinsekuchen; Sonnenschein
Grundeigentümer	Person mit Grundeigentum
Gründer	gründende Person
Gründerzeit	Gründungszeit
Gründerzentrum	Gründungszentrum; Innovationszentrum; Technologiezentrum
Grundrechtsträger (sg.)	grundrechtsberechtigte Person
Grundschüler (sg.)	Grundschulkind
Grundschüler (pl.)	Kinder in der Grundschule
Gruppenleiter (pl.)	Gruppenleitende; Gruppenleitung
Guide [Tourguide]	Reiseführung; Reiseleitung
Guru	spirituelles Vorbild / Idol
Gutachter (sg.)	begutachtet von ...
Gutachter (pl.)	Sachverständige; Begutachtende
Gymnasiast	Person auf einem Gymnasium; ein Gymnasium besuchende Person; gymnasial lernende Person
Gynäkologe	medizinisches/ärztliches Fachpersonal für Gynäkologie
Hacker (pl.)	Personen, die fremde Digitaldaten nutzen; Hackende; umfunktionierende Personen; Cyber-Kriminelle
Hackerangriff	Hackingangriff; Hackangriff
Hamburger (pl.)	die Hamburger Bevölkerung
Handelspartner (sg.)	Handelsallianz; Handelskontakt; Handelspartei
Handlanger	helfende Person; rechte Hand von jemandem
Händler	Shops; der Handel; Handelnde
Handwerker (sg.)	handwerkliches Fachpersonal; handwerkliche Fachkraft
Handwerker (pl.)	Handwerksbetriebe; Handwerksleute; Handwerkende; Fachpersonal im Handwerk
Handwerksmeister	Fachkraft mit Meisterbrief
ein Hansdampf (in allen Gassen)	Multitalent; Universalgenie; vielseitig begabter Mensch
Hauptcharakter	Hauptfigur; zentrale Gestalt; Schlüsselfigur; Titelrolle
Hauptfachlehrer (pl.)	Hauptfachgruppe; Fachgruppe
Häuptling	Oberhaupt
Hauptmänner	Hauptleute
Hauptmieter	Hauptmietpartei; Hauptmietperson; Hauptmietvertragsperson
Hausarzt	hausärztliche Fachkraft; Hauspraxis
Hauseigentümer (pl.)	Hauseigentum Innehabende
Hausdame (in Hotels)	Hausservice
Hausfrau	haushaltsführende Person; Haushalt organisierende Person; Haushaltsvorstand
Hausherr	Familienvorstand; Hausvorstand
Hausherren [in der Sportberichterstattung]	gastgebender Verein
Hausmannskost	einfache Küche; gut bürgerliche Küche; traditionell zubereitete Gerichte; Alltagsessen
Hausmeister (sg./pl.)	Gebäudemanagement
Hauswart	Hauswartung
Hebamme laut Hebammengesetz HebG §3
geburtshelfende Person	Begriff nicht ganz treffend, da zum Beruf auch Aufgaben außerhalb der direkten Geburtshilfe gehören: Betreuung in der Schwangerschaft
Abs. 2 gilt die Bezeichnung Hebamme für alle
und nach der Geburt
Berufsangehörigen
Hebammen laut Hebammengesetz HebG §3
Geburtshelfende	Begriff nicht ganz treffend, da zum Beruf auch Aufgaben außerhalb der direkten Geburtshilfe gehören: Betreuung in der Schwangerschaft und
Abs. 2 gilt die Bezeichnung Hebamme für alle
nach der Geburt
Berufsangehörigen
Heinzelmännchen	Heinzelchen
Held	Schlüsselperson; Hauptperson; außerordentlich erfolgreiche Person; Vorbild
Helfer (sg.)	Hilfskraft; Assistenz
Helfer (pl.)	Helfende
... ehrenamtliche Helfer (pl.)	Ehrenamtliche; Freiwillige; (ehrenamtlich) Engagierte
... Humanitäre Helfer (pl.)	... Humanitäre Helfende
Helfersystem	Hilfesystem
Herausgeber (sg./pl.)	herausgegeben von ...
Herr ...	...
... einer Sache Herr werden	... etwas in den Griff bekommen; etwas unter Kontrolle bekommen; etwas besser überblicken können
... nicht mehr Herr seiner Sinne sein	... nicht wissen, was man tut
... sein eigener Herr sein	... unabhängig sein; sich nach niemandem richten müssen
... aus aller Herren Länder	... aus aller Welt; aus der ganzen Welt
... Herr der Lage sein	... den Überblick haben; alles unter Kontrolle haben
Herrenfahrrad	Diamantrahmenfahrrad
Herrenhaus	Gutshaus
herrenlos	verlassen; nicht zuzuordnen; unbeaufsichtigt; personenlos; frei; besitzlos
... ein herrenloser Koffer	... ein verlassener/nicht zuordenbarer Koffer; ein Koffer, der keiner Person gehört
Herrschaften	Personen; Leute
Herrscher (sg.)	Staatsoberhaupt
Hersteller (sg.)	Herstellfirma; herstellendes Unternehmen
Hexe	Zauberkraft innehabende Person; Person mit Zauberkräften; mit Zauberkräften ausgestattete Person; Person, die Zauberkraft hat
Hinterbliebener	hinterbliebene Person; zurückgelassene Person
Hinterbliebene	[im Plural ist dieses Wort schon gendergerecht]
Hintermann	Graue Eminenz; Schlüsselfigur; aus dem Hinterzimmer; drahtziehende Person; dahinter steckt/steht ... ; verantwortliche Person
Hintermänner	Schlüsselfiguren; aus dem Hinterzimmer; Hinterleute; Verantwortliche
Hinweisgeber (sg.)	Hinweis gebende Person
Hinterbliebene (pl.)	[im Plural ist dieses Wort schon gendergerecht]
Hirte	hütende Person
Historiker (pl.)	Geschichtsforschende
Hörer (sg.)	zuhörende Person
Hörer (pl.)	zuhörende Personen
Hospitant	hospitierende Person
Hospitanten	Hospitierende
Hostessen; Hosts	Gästebetreuende siehe Anmerkung unter 'Gäste'
Humanist	humanistische Person
Hundehalter (sg.)	Person, die einen Hund hält
Ich-Erzähler	Ich-Form; Ich-Figur; erzählendes Ich
Ikone	bereits genderneutral
Illustrator	illustrierende Person
Illustratoren	Illustrierende
Imker	Bienenzüchtende Person
Immigranten (pl.)	Menschen mit Migrationshintergrund /-geschichte /-biografie
Immobilienbesitzer (pl.)	Immobilienbesitzende
Immobilieneigentümer (pl.)	Personen mit Immobilienbesitz; Immobilienbesitzende
Immobilienkaufmann	Immobilienfachkraft
Individuum	[als Neutrum ist dieses Wort schon gendergerecht: DAS Individuum]
Industriekaufmänner	Industriekaufleute
Industriemechaniker (sg.)	Industriemechanik ausführende Person
Influencer (sg.)	Content gestaltende Person; influencende Person
Informant	Informationsquelle; Quelle
Informatiker (sg.)	auf den IT-Bereich spezialisierte Person
Informationssicherheitsbeauftragter	beauftragte Person für Informationssicherheit
(Diplom-)Ingenieur	Person mit Ingenieursdiplom
Ingenieurberuf	Ingenieursberuf
Ingenieure (pl.)	Ingenieursberuf Ausübende
Ingenieurwesen	Technikwissenschaften; technische Wissenschaften; Technik
Inhaber (sg.)	etwas innehabende Person
inhabergeführt	besitzgeführter; besitzgeleiteter
Inhaber (pl.)	Inhabende
Inhaftierter	Person in Haft
Initiator	initiierende Person
Initiatoren	Initiierende
Inlineskater (pl.)	Inlineskatende
Insider (sg.)	Person, die Internas kennt / weiß; Person mit besonderem Hintergrundwissen
Inspekteur	Inspektion durchführende Person
Insasse (sg.)	inhaftierte Person
Insasse [Fahrzeuginsasse]	mitfahrende Person
Intendant	Intendanz
Interakteur	interagierende Person; 
Interakteure	Interagierende; in Interaktion Tretende
Interessensvertreter	Interessensvertretung
Interessenten (pl.)	Interessierte
Interessenträger	interessierte Beteiligte
Interimspräsident	Übergangsleitung
Internist	ärztliche Fachkraft für Innere Medizin
Interpret	Act
Interviewer (sg.)	interviewende Person
Interviewer (pl.)	Interviewende
Interviewpartner (pl.)	Interviewte; Befragte
Investor	geldgebende Person; Person, die Geld investiert hat; investierende Person
Investoren	Investierende
Italiener	aus Italien stammende Person; Person aus Italien
Jäger (sg.)	jagende Person; Person auf der Jagd
Jäger (pl.)	Jägerschaft; jagende Personen; Personen auf der Jagd
Jäger- und Sammler-Gesellschaft	nomadisierende Gesellschaft, die sich von der Jagd und dem Sammeln von Pflanzen ernährt
Jahrgangsbester	jahrgangsbeste Person
jeder	alle; alle für sich; sämtliche
... Jeder kann teilnehmen.	... Alle können teilnehmen.
... Jeder einzelne sucht sich einen Platz.	... Alle suchen sich ihren eigenen Platz. / Alle suchen für sich einen Platz. / Suche dir deinen Platz.
... jeder, der ...	... alle, die ... ; jene, die ...
... jeder Mitarbeiter	... sämtliche Mitarbeitenden
... jeder wie er möchte	... alle wie sie möchten
... Jedem das Seine. Der Gebrauch dieser
Redewendung ist unabhängig von
... Geschmäcker sind verschieden.
gendergerechter Sprache umstritten, da sie am
Eingang des KZ Buchenwald prangte.
jedermann	alle; sämtliche; jeder Mensch
jemand, der ...	eine Person, die ...; ein Mensch, der ...
... Ich suche jemanden, der gut Englisch spricht.	... Ich suche jemanden/eine Person/einen Mensch mit guten Englischkenntnissen.
Journalist	Presse; Medien; jemand von der Presse/vom Fernsehen/...; wer für die Zeitung/fürs Fernsehen berichtet
Journalisten	im Journalismus Tätige/Arbeitende; Medienschaffende; Presse; die Medien
Jubilar	Jubiläum begehende Person; Jubiläum feiernde Person
Juden (pl.)	Menschen jüdischen Glaubens; jüdische Menschen; Mitglieder / Angehörige der jüdischen Gemeinschaft / des jüdischen Volkes
Jugendlicher (sg.)	junge Person; junger Mensch; Teenie; Teen; Teenager
jungfräulich	unangetastet; makellos; unberührt; unverändert; ursprünglich; rein; frisch; unerschlossen; unbearbeitet
Jurist	Person mit juristischer Ausbildung; Person mit juristischem Sachverstand
Juror	Jurymitglied
Justiziar	rechtsberatende Person
Kamerad [militärisch]	Wegbegleitung; solidarisch wegbegleitende Person; Teammitglied
Kameramann	Kameraperson; Kamera
Kameramänner	Kamerateam; Kameraleute; Kamera; Kamerapersonen
Kämmerer	Leitung der Kämmerei
Kampfrichter (pl.)	Kampfjury; Schiedsgericht
Kampfrichterverzerrung	Verzerrung durch Kampfrichtende
Kandidaten	Kandidierende
Kandidatenfrage	Personalfrage; K-Frage
Kandidatenvorschlag	Personalvorschlag
Kanzler	Regierung (an-)führende Person; Regierungsoberhaupt
Kanzleramt	Amt des Regierungsoberhauptes
Kanzler-Frage	K-Frage
Kapitalgeber (pl.)	Investierende; Finanzierende
Kapitäne (pl.)	Schiffsführende
Karnevalisten	Karneval Feiernde
Karteninhaber (sg.)	die Karte besitzende Person; karteninhabende Person; Publikum
Kassenwart	Kassenverwaltung; Finanzverwaltung; Vermögensverwaltung
Kassierer (sg.)	Person an der Kasse
Katholiken	Menschen katholischen Glaubens
Käufer (pl.)	Kaufende; Kundschaft
Kaufmann	Kauffachkraft
... Kaufmann für Büromanagement	... Kauffachkraft für Büromanagement
Kaufmänner	Kaufleute
kaufmännisch	zahlentechnisch; finanztechnisch; in Zahlen gesehen; kauftechnisch; in Zahlen gesehen; buchungstechnisch; fiskalisch; (markt-)wirtschaftlich; ökonomisch; geschäftlich; gewerblich; kommerziell
... eine kaufmännische Ausbildung	... Ausbildung zur Fachkraft für Büromanagement
... ein kaufmännischer Beruf	... Berufsfeld Wirtschaft
keiner	niemand
keiner, der ...	kein Mensch, der ...; keine Person, die ...
Kellner (sg.)	Servicekraft; Bedienung
Kenner (pl.)	Fachleute; Begeisterte
Keramiker (sg.)	Keramikfachkraft
Kernwählerschaft	Kernwahlvolk; Kernstimmvolk
Keyplayer (sg.)	Schlüsselfigur
KfZ-Mechaniker	KfZ-Mechanik-Fachkraft
KfZ-Mechaniker-Innung	KfZ-Handwerks-Innung; KfZ-Innung; KfZ-Mechanik-Innung; Innung der KfZ-Mechanik
Kinderarztpraxis	Praxis für Kinderheilkunde
Kindergärtner	pädagogische Fachkraft; Erziehungskraft; Kita-Fachkraft
Kindermädchen	Kinderbetreuung; Aupair
Kindertagepfleger	Kindertagespflegeperson
Kläger (sg.)	klagende Person
Klassenkamerad	Person aus der eigenen Schulklasse
Klassensprecher	Klassenvertretung
Kleinbauern	kleine Landwirtschaftsbetriebe
Kletterer (sg.)	kletterbegeisterte Person; kletternde Person
Kletterer (pl.)	Kletternde; Kletterbegeisterte
Klient	ratsuchende Person; Beratung in Anspruch nehmende Person; Person, die in die Beratung kommt; Fall; Besuch
Klienten	Klientel; Ratsuchende
Klientenkontakt	Klientelkontakt
klientenorientiert	orientiert am Bedarf der ratsuchenden Person
Klientenzahl	Zahl der Ratsuchenden
Klimaschützer (pl.)	Klimaschützende
Koch	leitende Küchenfachkraft; Küchenpersonal; Kochprofi; Lebensmittel verarbeitende Person; in der Küche arbeitende Person; kochende Person; für das leibiche Wohl zuständige Person
Kollege	mitarbeitende Person; Teammitglied
Kollegen	Kollegschaft; Kollegium; Teammitglieder; Team
... Unterstützung eines Kollegen	... kollegiale Unterstützung
Kolonialherr	Kolonialmacht; Suzerän
Kolonialherren	Kolonialmächte
Kolonist	Koloniegründung; Kolonieerschließung
Komiteegründer	Komiteegründung
Kommentator	kommentierender Pressemensch; kommentierende Presse; Kommentar
Kommentatoren	Kommentare; Kommentar von Medienschaffenden
Kommilitone (sg.)	mitstudierende Person
Kommilitonen (pl.)	Mitstudierende
Kommissionierer	Mitarbeitende in der Warenzusammenstellung
Kommunikator [als Person; nicht als Gerät]	kommunizierende Person
Kommunist	kommunistisch (orientierte) Person
Komparse	stumme Rolle; Person ohne Sprechrolle; Nebenfigur
Kompetenzträger (sg.)	Kompetenz tragende Person
Kompetenzträger (pl.)	Kompetenztragende
Komponist	musikschaffende Person; kompositionstätige Person
Komponisten	Musikschaffende; Kompositionstätige
Konfirmand	zu konfirmierende Person; Konfi
Konfirmanden	zu Konformierende; Konfis
Konfirmanden (pl.)	Jugendliche in der Konfirmationsvorbereitung
Konfirmandenunterricht	Konfirmationsunterricht
Königsdisziplin	anspruchvollste Disziplin; Spitzendisziplin
Königsklasse	Oberliga; höchste Klasse
Konkurrent	Konkurrenz
Konsortialpartner (pl.)	Konsortialbeteiligte
Konstrukteure	Konstruierende
Konsumenten	Konsumierende; Kundschaft; einkaufende / konsumierende Zielgruppe
Kontrahent	Gegenüber
Kontoinhaber (sg.)	kontoinhabende Person; kontoführende Person
Kooperationspartner (sg./pl.)	in Kooperation mit; Kooperationsbeteiligte
Koordinator	Koordination
Körperspender	Körperspende
Korrektoren	Korrigierende
Kraftfahrer (sg.)	fahrzeugführende Person
... Welche Voraussetzungen erfüllen Sie für die	... Welche Voraussetzungen erfüllen Sie für die Tätigkeit als fahrzeugführende
Tätigkeit als Kraftfahrer eines Absetzkippers?	Person eines Absetzkippers?
Kraftfahrer (pl.)	Kraftfahrzeugführende
Krankenpfleger (sg.)	Pflegefachkraft; Pflegekraft; Pflegefachperson
Krankenpfleger (pl.)	Pflegekräfte; Pflegefachpersonen; Pflegepersonal; Beschäftigte in der Krankenpflege; professionell Pflegende; Pflegende
Krankenschwester	Pflegefachkraft; Pflegekraft; Pflegefachperson
Krankenschwestern	Pflegekräfte; Pflegefachpersonen; Pflegepersonal; Beschäftigte in der Krankenpflege; professionell Pflegende; Pflegende
Kranker	kranke Person
Kreditnehmer (sg.)	kreditnehmende Person
Kreditnehmer (pl.)	Kreditnehmende
[Erster] Kreisbeigeordneter	[Erste] Kreisbeigeordnete Person
Kriegerkodex	Kodex der Kämpfenden
Kriegsverbrechertribunal	Tribunal für Kriegsverbrechen
Kriminalbeamter	Person im Beamtenverhältnis bei der Kriminalpolizei
Kritiker (pl.)	Kritisierende; Kritische; kritische Stimmen
Küchenhelfer (sg.)	Küchenhilfe
Kümmererin	fürsorgliche Person; kümmernder Mensch; fürsorgliches Teammitglied/Chormitglied/...
Kunde	Kundschaft; Klientel; kaufende Person; konsumierende Person; Mensch; Person; nutzende Person; kaufinteressierte Person; Client; Account; Dienstleistung in Anspruch nehmende Person 
Kunden	Kundschaft; Klientel; kaufende Personen; Menschen; Personen; Nutzende; Auftraggebende; Nachfrage; Zielgruppe; Kaufinteressierte; Interessiete; Kreis; Gäste; Publikum; Betroffene
Kundenauftrag	Auftrag durch Kundschaft; Auftrag
Kundenbedürfnisse	Bedürfnisse der Kundschaft
Kundenberater	Beratung der Kundschaft
... Ihr persönlicher Kundenberater	... Ihre persönliche Ansprechperson; ... Sie werden persönlich beraten von/durch ...
Kundenberatung	Beratung der Kundschaft
Kundenbetreuer	Betreuung der Kundschaft
Kundenbewertungen	Bewertungen; Bewertungssterne; Sterne-Bewertungen
Kundendienst	Service; Support
kundenfreundlich	praktisch zu bedienen; publikumsfreundlich; nutzungsfreundlich
Kundengruppe	Kundschaft [mit bestimmtem Merkmal, z.B. Kundschaft mit geringer Kaufkraft]
Kundenkontakt	Menschenkontakt; Kontakt zur Kundschaft; Kontakt
Kundenkonto	Nutzungskonto; Konto; Profil
Kundenkreis	Zielgruppe
Kundennummer	Nummer; persönliche Nummer; zugeordnete Nummer
kundenorientiert	publikumsorientiert; zielgruppenorientiert
Kundenorientierung	Publikumsorientierung; Zielgruppenorientierung
Kundenprojekt	Kundschaftsprojekt
Kundenreferenz	Referenz
Kundenservice	Service
Kundenstamm	treue Kundschaft; feste Kundschaft; Kundschaftsstamm; Klientelstamm
Kundenwerbung	Akquise
Kundenwunsch	Sonderwunsch
Kundenwünsche	Wünsche der Kundschaft; Sonderwünsche
Kundenzentrum [digital/analog]	Servicezentrum
Kundenzufriedenheit	Zufriedenheit der Kundschaft
Kunstfreunde	Kunstbegeisterte
Kunstkenner (pl.)	Kunstkennende
Künstler (sg.)	Act; kunstschaffende Person
Künstler (pl.)	Kunstschaffende
Künstlerbuch	künstlerisches Konzeptbuch
Künstlerkolonie	Kunstsiedlung
Künstlername	(künstlerisches) Pseudonym; Kunstname
Kunstsammler (pl.)	Kunstsammelnde
Kuratoren	Kuratierende; kuratorische Leitung
Kurier	überbringende Person; überbringender Lieferservice
Kursadministrator	Person, die den Kurs leitet; Kursadmin
Kursbetreuer	Kursbetreuung
Kursleiter (sg.)	Kursleitung; kursleitende Person
Kursteilnehmer (sg.)	am Kurs teilnehmende Person
Kursteilnehmer (pl.)	Kursteilnehmende; am Kurs Teilnehmende; Kurs
Kurzarbeitergeld	Kurzarbeitsgeld
Laborant	Laborfachkraft
Laborarbeiter (sg.)	Laborfachkraft
Lagerist	Lagerfachkraft; im Lager arbeitende Person
Laie	Mensch ohne Fachkenntnisse; fachunkundige Person; fachfremde Person
Laien	Fachunkundige; Fachfremde; Nichtkundige
Landnutzer	landnutzende Personen
Landrat	Landkreisleitung; Kreisverwaltungsleitung; Landratsamtsleitung; Dienststellenleitung; Amtsvorstand
Landsmänner	Landsleute
Landwirt	Landwirtschaft betreibende Person
Landwirte	Landwirtschaft Betreibende; landwirtschaftlich Beschäftigte; Beschäftigte in der Landwirtschaft
Lastkraftwagenfahrer	Lastkraftwagen fahrende Person
Läufer	laufsporttreibende Person
Lebemann	Genussmensch
Lebenspartner	Liebesmensch; Lebensmensch; verpartnerte Person
... eingetragener Lebenspartner	... erfasste verpartnerte Person; vermerkte verpartnerte Person
Lehrer (sg.)	Lehrperson; Lehrkraft
Lehrer (pl.)	Lehrkräfte; Lehrpersonen; das Kollegium; Lehrende; Unterrichtende
Lehrerberuf	Lehrberuf
Lehrerkonferenz	Kollegiumskonferenz; Konferenz; Konferenz der Lehrkräfte; Besprechung der Lehrkräfte
Lehrerpult	Tisch/Pult der Lehrkraft; Schreibtisch
Lehrerzimmer	Arbeitszimmer der Lehrkräfte; Teamraum; Kollegiumszimmer
Lehrling	Nachwuchskraft; Person in Ausbildung; auszubildende Person; lernende Person
Lehrlinge	Auszubildende; Lernende
Lehrmeister (pl.)	Ausbildende; Lehrende
Lehrstuhlinhaber (sg.)	Leitung des Lehrstuhles
Lehrstuhlinhaber (pl.)	Leitende eines Lehrstuhles
Lehrstuhlleiter (sg.)	Leitung des Lehrstuhls
Lehrstuhlleiter (pl.)	Leitende eines Lehrstuhles
Leibeigener	leibeigene Person
Leibeigene	[im Plural ist dieses Wort schon gendergerecht]
Leiharbeiternehmer (pl.)	Leiharbeitnehmende
Leistungsbezieher (pl.)	Leistung Beziehende
Leistungsempfänger (pl.)	Leistungsempfangende
Leistungsträger	refinanzierende Ämter und Behörden
Leiter (sg./pl.)	Leitung
Lektor	das Lektorat
... Anmerkungen des Lektors	... Anmerkungen des Lektorats
Lektorstelle	Lektoratsstelle
[Fahrzeug-]Lenker	Fahrzeug lenkende Person
Lernbegleiter (sg.)	lernbegleitende Person
Lerntyp	[Begriff ist schon genderneutral]
Lernender (sg.)	lernende Person
Leser (sg.)	lesende Person
... An den werten Leser	... An die werten lesenden Personen
Leser (pl.)	Lesepublikum; Leserschaft; lesende Zielgruppe; Lesende
Leserausweis	Leseausweis; Bibliotheksausweis
Leserbrief	Zuschrift / Kommentar zum Artikel xy
Leserbriefe	Ihre Kommentare/Meinungen; offene Zuschriften
leserfreundlich	lesefreundlich
Lesermarkt	Markt der Lesenden; Lesendengeschäft; Lesendenabsatz
Lieber ... [informelle Anrede bei Briefen]	An ...; Hallo ...; Guten Tag ...
Liebhaber (pl.)	Begeisterte
... Wir richten uns an Modellbauliebhaber.	... Wir richten uns an Modellbaubegeisterte.
Liedermacher (pl.)	Liederschaffende; Lieder kreierende Personen
Lieferant	Lieferfirma; lieferndes Unternehmen; Lieferunternehmen
Linguist	auf Linguistik spezialisierte Person; linguistische Fachkraft
Linker	links gesinnte Person [Anm.: Im Plural schon genderneutral.]
Linkshänder	linkshändige Person
Literaturkritiker (sg.)	Literatur kritisierende Person
Literaturkritiker (pl.)	Literaturkritisierende
Lizenznehmer (pl.)	Lizenznehmende
Lobbyist	Interessen vertretende Person
Logopäde	(medizinische) Fachkraft für Logopädie
Macher (pl.)	Aktive
Mädchen für alles	Mensch für alles
Mädchenname	Geburtsname
Magier	Zauberkunst ausübende Person
Makler (pl.)	Häuser vertreibende Personen
Maklergebühren	Gebühren; Vermittlungsgebühren
Maklerverbund	Maklerei
Maler (sg.)	Werkschaffende Person der Malerei; Wandgestaltende Person
Maler (pl.) [künstlerisch]	Werkschaffende der Malerei
man	Sie; viele; wir; ich
Manager (sg.)	Management; Unternehmensführung; Führungskraft
manch einem	manch einer Person
... Manch einem ist gar nicht klar, was er damit
... Manchen ist gar nicht klar, was sie damit anrichten.
anrichtet.
Mandant	Mandantschaft; auftraggebende Person
Mandatsträger	Mandat innehabende Person; mandatstragende Person
Manipulant	manipulierende Person
Mann ... [im Sinne von:]	Person(en) ...
... es kamen 40 Mann.	... es kamen 40 Personen / Leute.
... alle Mann an Bord!	... alle an Bord!
... Mann über Bord!	... Person über Bord!
... Der Gewinn betrug 20 Euro pro Mann.	... Der Gewinn betrug 20 Euro pro Person / Nase.
... etwas am Mann tragen	... etwas bei sich tragen
... etwas an den Mann bringen	... etwas unter die Leute bringen; etwas verkaufen; ein Anliegen loswerden
... Not am Mann	... Notsituation
... Ein-Mann-Betrieb	... Eine-Person-Betrieb
... Zwei-Mann-Zelt	... Zwei-Personen-Zelt; Zweier-Zelt
... seinen Mann stehen	... auf sich gestellt sein; sich behaupten; sich bewähren
... 3. Mann [beim Skat]	... 3. spielende Person
... 1000-Mann-Quote	... 1000-Personen-Quote
... Mann oder Maus?	... mutig oder feige?
Männchen [z.B. bei Brettspielen]	Figürchen; Spielfigur
Manndeckung [im Sport]	1:1-Verteidigung; 1:1-Deckung; personenorientierte Deckung; Direktdeckung [Gegensatz zur Raumdeckung]
mannlos	personenlos; computergesteuert; autonom; unbesetzt; selbstständig
Mannmonat	Mitarbeitendenmonat; Personenmonat
mannshoch	lebensgroß
Manntage	Arbeitstage; Leistungstage; Personentage
Mannsbild	gestandene Person; Powermensch
Mannschaft	Team; Gruppe; Kollektiv; Besatzung [bei Schiffen]
... Damenmannschaft	... Damenteam
... Frauenmannschaft	... Frauenteam
... Mädchenmannschaft	... Mädchenteam
Mannstunde	Personenstunde
Manpower	Arbeitskraft; Humanpower
Marktakteure	am Markt agierende Menschen und Institutionen
Marktschreier (pl.)	Angebotsausrufende
Masterand	studentische Stelle zur Anfertigung der Masterarbeit
Mathematiker (sg.)	mathematisch qualifizierte Person; sich mit Mathematik befassende Person
Matrose	Mitglied der Schiffsbesatzung (mit unterstem Dienstrang) u.U. zu ungenau, da z.B. auch die*der Kapitän*in Mitglied der Schiffsbesatzung ist
Mechaniker (sg.)	Fachkraft für Mechanik
Mechatroniker (sg.)	Fachkraft für Mechatronik
Mediator	Mediation; Mediationsperson; Mediation anbietende Person
Medienanbieter (pl.)	Medienorganisationen
Mediengestalter (pl.)	Mediengestaltende
Medienpartner	in Medienpartnerschaft mit ...
Mediziner (pl.)	medizinisches/ärztliches Fachpersonal; in der Medizin Tätige
Mehrbenutzerfunktion	Funktion für mehrere Nutzende; Gruppenfunktion
Meinungsführer (sg.)	meinungsführende Person
Meinungskontrahent	Meinungsgegenpart
Meister [im Handwerk]	Person mit höherer Fachprüfung
(Deutscher / Welt-) Meister	Erster Platz der Deutschen Meisterschaft / Weltmeisterschaft; Erstplatzierte (pl.)
Meisterschaft	Turnier; Wettbewerb
Meldender	meldende Person; Meldung von ... ; gemeldet durch ...
Mensch	[ist bereits genderneutral; analog zur PERSON]
Mentee	begleitete Person; beratene Person; geförderte Person; Person in Ausbildung; durch Mentoring begleitete/unterstützte Person
Mentor	Vorbild; fürsprechende Person; beratende Person; fördernde Person; Begleitung; Kontaktperson; Ansprechperson; Ausbildungsbeauftragte Person
betrieblicher Mentor	... betriebliche Mentoringperson; betriebliche Mentorperson
Mieter (sg.)	Mietperson; Mietpartei
Mieterverein	Mietverein; Mietvertretung
Migrant	Person mit Migrationshintergrund; eingewanderte Person; der/die Migrierte; Person mit internationaler Geschichte
Migranten (pl.)	Personen mit Migrationshintergrund; Eingewanderte; Zugewanderte; Migrierte; Personen mit internationaler Geschichte
Milchmädchenrechnung	Trugschluss; Irrtum; falsche Erwartung; Fehlschluss; Illusion
Minderjähriger (sg.)	Kind unter 18; minderjährige Person; nicht volljährige Person
Mindestteilnehmerzahl	Mindestanzahl Teilnehmende
Minijobber (pl.)	geringfügig Beschäftigte
Minister (sg.)	Ressortleitung
Minister (pl.)	Ressortleitende
Ministerpräsidenten	MPs; Landesoberhaupt; Vorsitz der Resortleitenden
Ministerpräsidentenkonferenz	MPK
Ministrant	Mini
Ministranten	Minis
Mitarbeiter (sg.)	Arbeitskraft; Teammitglied
Mitarbeitende; Beschäftigte; Angestellte; Tätige; Belegschaft; Teammitglieder; Arbeitskräfte; Kollegium; Personal; Teammitglieder; Werktätige; Betriebs-/Konzern-
Mitarbeiter (pl.)	/Firmen-/Unternehmensangehörige; bei uns beschäftigte Personen; Festangestellte; Arbeitsgemeinschaft; Arbeitsgruppe; Beteiligte; Crew; Gruppe; Servicekräfte;
Servicepersonal; Team
... Mitarbeiter in Teilzeit	... Teilzeitkraft
... Mitarbeiter der Hochschule / Unimitarbeiter	... Hochschulpersonal
... freiwillige Mitarbeiter eines Projektes, eines
Vereins, einer Jugendgruppe (nicht als	... Mitglieder; Helfende; Freiwillige; Unterstützende
Beschäftigte) (pl.)
Mitarbeiterausweis	Firmenausweis; Mitarbeitendenausweis; MA-Ausweis; Arbeitsausweis; Dienstausweis
Mitarbeiterbeurteilung	Personalbeurteilung; Angestelltenbeurteilung
Mitarbeiterführung	Personalmanagement; Personführung; Personalpolitik
Mitarbeitergespräch	Dienstbesprechung; Qualifikationsgespräch; Arbeitsgespräch; Beurteilungsgespräch; Jahresgespräch; Beschäftigtengespräch; Personalgespräch; Mitarbeitendengespräch
Mitarbeitermobilität	Mobilität der Mitarbeitenden; Mitarbeitendenmobilität
Mitarbeiterorientierung	orientiert an den Mitarbeitenden; Mitarbeitendenorientierung
Mitarbeiterperspektive	Perspektive der Mitarbeitenden; Perspektive der Belegschaft
Mitarbeiterrabatt	Mitarbeitendenrabatt; Unternehmensrabatt; Jobrabatt
Mitarbeiterschulung	Schulung; Schulung der Belegschaft; MA-Schulung; Schulung der Mitarbeitenden
Mitarbeitersuche	Personalsuche; Mitarbeitendensuche
Mitarbeiterstellen	Stellen für Mitarbeitende; Arbeitsplätze
Mitarbeiterverpflegung	Personalverpflegung
Mitbewerber (pl.)	die Konkurrenz
Mitbewohner (pl.)	Wohnungsteilende
Mitbürger (sg.)	Mitmensch
Mitbürger (pl.)	Landsleute; Mitmenschen; Staatsangehörige
Mitfahrergelegenheit	Mitfahrgelegenheit
Zugehörige; Angehörige; Teil von ...Mitläufer (sg.)	Folge leistende Person; involvierte Person; passives Engagement; passive Rolle; mitlaufende Person
Mitschüler (pl.)	andere Kinder aus der Klasse / Schule; Mitlernende
Mitspieler (pl.) [beim Sport]	Mitspielende
Mitstreiter (pl.)	Mitwirkende; Teilnehmende; Gleichgesinnte
Mittelsmann	Mittelsperson; Mittelsmensch
Mittelständler (pl.)	mittelständische Unternehmen; Angehörige des Mittelstandes
Mitwisser (pl.)	Eingeweihte
Moderator	Moderation; moderierende Person
Moderatoren	Moderationsteam; Moderierende
Modeschöpfer (pl.)	Mode Schaffende
Mofafahrer (pl.)	Mofa Fahrende
Mönch	Ordensperson
Mönche	Ordensleute
Montagsmaler	Montagsmalen
Monteur	montierende Person; Montagedienst
Mörder (sg.)	einen Mord begehende Person; mordende Person
Müllmann	Müll entsorgende Person; Fachkraft für Kreislauf- und Abfallwirtschaft
Müllmänner	Beschäftigte der Müllabfuhr; Müllabfuhr
Multiplikator	Person, die Informationen/Wissen weitergibt; Wissen/Informationen weitergebende Person
Münchner (pl.)	die Münchner Bevölkerung
Museologe	museumswissenschaftliches Fachpersonal
Musiker (sg.)	Act
Musiker (pl.)	Musikausübende; Musikschaffende; Musikspielende; Musizierende; Mitglieder eines Orchesters; Bandmitglieder
Muslim	Mensch muslimischen Glaubens
Musterknabe	Vorbild; Musterschulkind; Musterkind
Mutmacher	mutmachende Person; aufmunternde Person; support
Mutter	Elternteil
... Mutter-Kind-Gruppe	... Eltern-Kind-Gruppe
... Mutter-Kind-Parkplatz	… Familienparkplatz
... Mutter Natur	... Natur; (freie/unberührte) Landschaft; Erde; Schöpfung; (natürliche) Umwelt; (das) Grüne; Naturreich
Mütterberatung	Elternberatung
Mutterleib	Körper der schwangeren Person
mütterlicherseits	[vornamen-]licherseits
Muttermal	Pigmentstörung; Leberfleck
Muttermilch	Elternmilch; Brustmilch
Mutterschutz	Elternschutz
Muttersprache	Erstsprache; erste Sprache; Hauptsprache; Elternsprache; Familiensprache; Heimatsprache 
Muttersprachler	Person mit der Erstsprache XYZ; Person, die XYZ als Erstsprache spricht; xyz-erstsprachliche Person (z.B. polnisch-erstsprachliche Person)
Nachahmer (pl.)	Menschen; andere; Menschen gleicher Gesinnung
Nachbarhaus	Haus nebenan; Nebenhaus
Nachbarn	nebenan Wohnende
Nachbarn [in einem Wohnhaus] (pl.)	Hausgemeinschaft
Nachbarschaft	Umgebung
Nachfahre	Abkömmling; Kind; Kindeskinder; Enkelkinder
Nachfahren	Nachkommenschaft; Nachkommen
Nachfolger (sg.)	Nachfolge
Nachfrager (pl.)	Nachfragende
Nachlassverwalter	Nachlass verwaltende Person
Nachrücker	nachrückende Person(en)
Nächster	nächste Person
Nachtschwärmer (sg.)	Nachtmensch; Partymensch
Nachtschwärmer (pl.)	Nachtleute
Nachwuchswissenschaftler (pl.)	wissenschaftlicher Nachwuchs
Näherinnen	Nähende
Namensvetter (pl.)	Gleichnamige
Narr [Karneval]	närrische Person
Narren [Karneval]	Närrische; Karneval Feiernde; Karneval Zelebrierende; Karnefalbegeisterte
Nationalmannschaft	Nationalteam
Nationalsozialist / Nazi	rechtsextreme Person; rechtsextrem eingestellte Person
Naturbursche	Naturmensch
Nebenmann	nebenstehende Person
Neffen und Nichten	Kinder der Geschwister
Netzwerkpartner (pl.)	Netzwerkbeteiligte; Netzwerkmitglieder
Neueinsteiger (sg.)	Nachwuchs; neu im Geschäft; unerfahrene Person; Grünschnabel; Mensch ohne Vorkenntnisse
Nichtraucher	nicht rauchende Person
niemand, der ...	keine Person, die ...; kein Mensch, der ...
Nonne	Ordensperson
Nonnen	Ordensleute
Normgeber	normgebende Person
Notar	notariell arbeitende Person
Novize	Neuling; Person im Noviziat
Nutzer (sg.)	(be-)nutzende Person; Person, die ... nutzt
Nutzer (pl.)	Personen, die ... nutzen; Nutzung; Mitglieder; Nutzende
... Nutzer des Angebots werden bevorzugt.	... Wer das Angebot nutzt, wird bevorzugt.
... Wie viele Nutzer hat das Fitnessstudio?	... Wie viele Mitglieder hat das Fitnessstudio?
Nutzerdaten	(persönliche) Nutzungsdaten; Datenspuren; Daten der Nutzenden
Nutzereingabe	Eingabe; Eingabe bei Nutzung
Nutzerentgelte	Nutzungsentgelte
Nutzergemeinde	Community; Netzwerk
Nutzergruppe	mit (folgenden) Aufgaben betrauter/arbeitender Personenkreis; Nutzungsgruppe
Nutzerhandbuch	Handbuch; Nutzungshandbuch
Nutzerkonto	Account; Konto; Zugang
nutzerorientiert	menschzentriert; nutzungsfreundlich; nutzungsorientiert
Nutzerzufriedenheit	Zufriedenheit mit der Nutzung; Bedienzufriedenheit
Oberarzt	ärztliche Führungskraft; fachärztliche Leitung
Oberbürgermeister	Stadtoberhaupt
Obmann	Obmensch; schiedsrichtende Person
Okapi	Tier
Ökonom	ökonomisch ausgebildete Person
Ökonomen	ökonomisch Ausgebildete
Ombudsmann	Ombudsperson
Opfer	[als Neutrum ist dieses Wort schon gendergerecht: DAS Opfer]
Opportunisten	eine die Gelegenheit ergreifende Person
Oppositioneller	Person in der Opposition; Person in den Reihen der Opposition [Anm.: Im Plural schon genderneutral.]
Organisatoren	Organisation; Organisationsteam/-komitee; organisiert von ...; Organisierende
Organspender (pl.)	Organ Spendende; Organ spendende Personen
Orthopädieschuhmacher	schuhherstellende Fachkraft mit orthopädischer Ausrichtung
Orthopädieschuhtechniker	orthopädieschuhtechnische Fachkraft
Orthopädietechniker	orthopädietechnische Fachkraft; technische Fachkraft für Othopädie
Otto Normalverbraucher	Durchschnittsmensch
Pächter (sg.)	pachtende Person
Pädagoge	pädagogische Fachkraft
Paketbote	Paketzustellung
Parlamentarier (pl.)	Abgeordnete
Papst	Oberhaupt der katholischen Kirche
... Papst [im übertragenen Sinn; z.B. Modepapst]	... Genie; Berühmtheit; Ikone
Parteichef	Parteivorsitz
Partner (sg.)	Gegenüber
Partner (pl.)	Unterstützung; Mitglied; Beteiligte; Kooperationen; Mitwirkende
Partnerarbeit	Zweierarbeit; Paararbeit; Tandemarbeit
... Löst die Aufgabe in Partnerarbeit!	... Löst die Aufgabe zu zweit. / Löst die Aufgabe im Tandem.
Partnerländer	Kooperationsländer
Partnerorganisation	(mit uns) kooperierende Institution
Partnerschaft	Beziehung; Kooperation; Zusammenarbeit; Tandem
Partnersuche	Lebensmenschsuche; Verbündetensuche; Seelenverwandtensuche; Suche nach dem Herzensmensch
Partnerwahl	Wahl eines Lebensmenschen
Passagier	reisende Person
Passagiere	Reisende
Passagierflugzeug	Reiseflugzeug
Passanten	Passierende; Vorbeiziehende; Vorübergehende; zu Fuß Gehende nur sehr eingeschränkt verwendbar, da Menschen, die nicht gehen können (z.B. Menschen im Rollstuhl), ausgeschlossen werden ; einen Ort passierende Personen; den Gehweg nutzende Personen;
Passantenbefragung	Straßenbefragung
Passinhaber	im Besitz eines Passes
Pastor	Geistliche Person der Kirche
Pate	Patenamt; Patenschaft
Pathologe	ärztliche Fachkraft für Pathologie
Patient (sg.)	zu behandelnde Person; kranke Person; zu versorgende Person; (Fach-)Beratung aufsuchende Person; Person, die sich in medizinische Hände begibt;Hilfesuchende Person; stationär aufgenommene Person; die uns anvertraute Person; Person, die medizinische Hilfe benötigt; Pat./Pat* [innerhalb der Dokumentation]
Patienten (pl.)	zu behandelnde Personen; zu Pflegende; Personen, die in (ärztlicher) Behandlung sind; Kranke; Erkrankte; Menschen mit einer Erkrankung; Menschen, die im Krankenhaus liegen; (von einer Krankheit) Betroffene; Behandelte; Hilfesuchende
... Krebspatienten	... von der Krebskrankheit Betroffene; Krebskranke
... Patienten-Arzt-Kommunikation	Kommunikation zwischen behandelnder und behandelter Person; behandlungsbezogene Kommunikation
... Privatpatient	Privatversicherte Person; Person mit privater Krankenversicherung
Patientenaufklärung	Aufklärung; Aufklärungsgespräch; Aufklärung über eine Behandlung
Patientencharakteristik	Betroffenencharakteristik; Erkranktencharakteristik
Patienteninformation	Information; Information für Sie; Informationen für Personen in Behandlung
Patientenkontakt	Betroffenenkontakt
patientennah	Point-of-Care
Patientenschulung [in der Psychologie]	Schulung für Erkrankte
Patientenverfügung	Verfügung(en) für betreute Personen
Patientenversorgung	ärztliche Versorgung; Behandlung; Pflege
Patientenzimmer	Gesundungszimmer; Heilungszimmer; Zimmer
Pazifist	Person, die für Frieden einsteht; friedensengagierte Person; pazifistische Person; friedliebende Person; friedfertige Person
Pazifisten	Friedensbewegte
Pendler (pl.)	Pendelnde
Pendlerpauschale	Entfernungspauschale; Pendelpauschale; Pauschale für Pendelnde; Pauschale für Menschen, die pendeln
Pensionäre	Pensionierte
Performer (pl.)	Performende
Personalentwickler	Personalentwicklung
Personalleiter	Personalleitung
Personalrat	Mitglied des Personalrates
Personalräte	Mitglieder des Personalrates; der Personalrat; Mitarbeitendenvertretung
Personalvertreter (pl.)	Personalvertretung
Pfadfinder (sg.)	Scout; Pfadi
Pfadfinder (pl.)	Pfadis; Pfadfindende
Pfarrer (sg.)	Pfarrperson
Pfleger (sg.)	Pflegekraft
Pfleger (pl.)	Pflegekräfte; Pflegepersonal; die Pflege; Pflegende
Pförtner (sg.)	Pfortenpersonal
Philosoph	gelehrte Person
Philosophen	Gelehrte
Physiker (sg.)	Person mit abgeschlossenem Physikstudium
Physiotherapeut	Physiotherapie praktizierende Person
Pilger (pl.)	Pilgernde; Menschen auf Pilgerschaft
Pilot	flugzeugführende Belegschaft
Pilotlabor	Koordinationslabor; Koordinierungslabor
Pilotphase	Testphase; Probebetrieb
Pilotprojekt	Versuchsvorhaben; Versuchsprojekt; Testphase
Pionier	vorkämpfende Person
Pionierarbeit	wegbereitende Arbeit; bahnbrechende Leistung
Planer (pl.)	planende Personen; planende Institutionen
Platzwart	für den (Sport-)Platz zuständige Person; den Platz betreuende Person; Pflege und Betreuung eines Sportplatzes
Podologe	Fachkraft für Podologie
Poet	lyrikschaffende Person
Politiker (sg.)	Mensch in der Politik; Mitglied der Politik; Polit-Größe; in der Politik tätige Person; Teil der Legislative
Politiker (pl.)	Menschen in der Politik; Menschen, die in der Politik tätig sind; Mitglieder der Politik; Politikschaffende
Polizist	Polizeikraft; Polizei
Polizisten (pl.)	Polizei; Polizeikräfte; Polizeileute
Polsterer	Polsterfachkraft
Postbote	Postzustellung
Powerfrau	Powermensch; gestandene Person
Praktikant (sg.)	eine ein Praktikum absolvierende Person; eine Person im Praktikum; eine sich in einem Praktikum(verhältnis) befindende Person
Praktikanten	Auszubildende im Praktikum
Praktikantenstelle	Praktikumsstelle
Praktiker (pl.)	Praktizierende; Leute aus der Praxis; praktisch veranlagte Menschen
Präsident	Staatsoberhaupt; Vorsitz
Präsidenten (pl.)	Vorsitzende
... die Vereinspräsidenten	... die Vereinsvorsitzenden
Präsidentenwahl	Präsidentschaftswahl
Praxispartner	Praxisbeteiligte; Praxismitbetreibende; Praxisunternehmen; Einrichtung zur praktischen Vertiefung;
Prediger (pl.)	Predigende
Preisträger (sg.)	ausgezeichnete Person
Pressesprecher	Pressevertretung; Öffentlichkeitsarbeit; Pressestelle
Priester	geistliche Person
Proband	Testperson; Versuchsperson
Probanden	Testpersonen; Versuchspersonen; Teilnehmende
Produzent	die Produktionsleitung innehabende Person
Produzenten	Produzierende; Produktionsteam
Professor	eine Professur innehabende Person; Prof.
Professoren	Professorenschaft
Professorenstelle	Professorale Stelle
Programmierer (sg.)	programmierende Person
Programmierer (pl.)	Softwareerstellende; Programmierende
Projektentwickler	Projektentwicklung
Projektleiter (sg.)	Projektleitung
Projektleiter (pl.)	Projektleitungen; Projektleitende
Projektpartner (pl.)	Projektbeteiligte; Projektmitwirkende; am Projekt beteiligte Firmen/Institute/etc.
Projektträger	Projektträgerschaft
Prokurist	Person mit Prokura; bevollmächtigte Person
Prokuristen	Personen mit Prokura; Prokura Innehabende; Prokura Ausübende
Proletarier (pl.)	Lohnabhängige; Werktätige; Arbeitende; Angehörige des Proletariats
Prominenter	prominente Persönlichkeit
Prostituierte	im Sexgewerbe tätige Person; sich prostituierende Person
Protagonist	Figur; Hauptperson; Hauptfigur; zentrale Gestalt; Schlüsselfigur; Titelrolle
Protagonisten	Hauptpersonen; Hauptfiguren; zentrale Gestalten; Schlüsselfiguren; Titelrollen; Aktive
Protokollführer (sg.)	protokollführende Person; Protokollführung
Prüfer (sg.)	Prüfungsleitung; Prüfungsabnahme durch ...; geprüft von ... ; Person, die prüft; prüfende Person
Prüfling	zu prüfende Person
Prüfstatiker (sg.)	Statik prüfende Person
Psychologe	psychologische Fachkraft
Psychologen	psychologische Fachkräfte
Psychotherapeut	psychotherapeutisches Fachpersonal; psychotherapeutische Fachkraft
Putzfrau	Reinigungspersonal; Reinigungskraft; Raumpflege
Querdenker	querdenkende Person; Querkopf
Querdenker-Demo	Querdenken-Demo
Quereinsteiger	quereinsteigende Person; fachfremde Person
Rabbiner (sg.)	Mitglied des Rabbinats
Rabbiner (pl.)	Rabbinat
Radfahrer (pl.)	Rad Fahrende; wer mit dem Rad unterwegs ist ...
... Radfahrer müssen absteigen.	... Fahrräder bitte schieben.
Radiologe	radiologisch-ärztliches Fachpersonal 
Ranger	Bewachung in Schutzgebieten; Gebietsüberwachung
Rassist	rassistische Person
Ratgeber [im Sinne einer Person; nicht Leitfaden]	Wegbegleitung; Beistand; ratgebende/beratende Person
Ratsherr	Mitglied des Stadtrats
Räuberleiter	Steighilfe; Raubleiter; Baumleiter; Dachlattentreppe
Raucherabteil	Abteil für Rauchende; Abteil zum Rauchen
Raucherbereich	Bereich für Rauchende; Bereich zum Rauchen; Rauchbereich
Raucherpause	Rauchpause; Zigarettenpause; Pause
Rechnungsempfänger (sg.)	die Rechnung empfangende Person
Rechnungsempfänger (pl.)	Rechnungsempfangende; Rechnungserhaltende
Rechnungsprüfer	Rechnungsprüfung; Person, die die Rechnungsprüfung macht; Person, die für die Rechnungsprüfung verantwortlich ist
Rechteinhaber (pl.)	Rechteinhabende
Rechter	rechts gesinnte Person [Anm.: Im Plural schon genderneutral.]
Rechthaber	rechthaberischer Mensch
Rechtsanwälte	Angehörige rechtsberatender Berufe
Rechtsextremer	rechtsextrem gesinnte Person [Anm.: Im Plural schon genderneutral.]
Rechtshänder	rechtshändige Person
Recruiter	rekrutierende Person
Redakteur	Redaktion; Redationsmitglied
Redner (sg.)	referierende Person; vortragende Person
Rednerliste	Redeliste
Rednerpult	Redepult
Referendar	Lehrkraft im Referendariat; LiV (Lehrkraft im Vorbereitungsdienst), referierende Person; vortragende Person; Referat
Referenten	Referierende; Vortragende
... Referenten waren ...	... Es referierten ...
Referententätigkeit	Referierendentätigkeit; Vortragstätigkeit; zuständig für Aufgaben im Referat xyz; zuständig für die Referatsleitung
Referentenvereinbarung	Vortragsvereinbarung; Honorarvereinbarung
Reformer (sg.)	reformierende Person; Reformperson
Reformer (pl.)	Reformierende
Regierungschef	Staatsoberhaupt; Regierung anführende Person
Regisseur	Regie
Rehasportler	Rehasportinteressierte
Reiseleiter	Reiseleitung
Reisender	reisende Person
Reiserückkehrer	zurückkommende Reisende 
Reiseveranstalter	Reiseveranstaltung; Reisebüro; Reiseorganisation; Reisekoordination; Reiseausrichtung; Reiseveranstaltende
Reiter	Person, die reitet
Rekrut	Nachwuchs (der Grundausbildung in der Bundeswehr)
Rektor	Schulleitung
Rentner (sg.)	Person im Ruhestand; Person in Rente
Rentner (pl.)	Menschen, im Rentenalter; Menschen, die in der Rente sind; Menschen in Rente
Reporter (sg.)	Presse; berichterstattende Person; Medienvertretung
Repräsentant	Vertretung
Rettungsassistent	Rettungsassistenz; mitarbeitende Person im Rettungsdienst
Rettungssanitäter	Rettungskraft; Rettungssanitätsdienst
Rettungsschwimmer (sg.)	aus dem Wasser rettende Person
Rettungshelfer	Rettungshilfe; rettungshilfeleistende Person
Rezeptionist	Empfang; Person/Personal am Empfang; Rezeption
Rezipient	rezipierende Person; empfangende Person
Rezipienten	Rezipierende; Publikum
Richter (sg.)	rechtsprechende Person
Richter (pl.)	Richterschaft
Ritter	Mensch in Rüstung
Ritterschlag	Belobigung; Ehrung; höchste Anerkennung einer Person
Ritterstand	regierender Adel
Rivale	Konkurrenz; Gegenpart
Rollstuhlfahrer (sg.)	Person im Rollstuhl
Ruderer (sg.)	rudernde Person
Sachbearbeiter (sg.)	Verwaltungskraft
Sachbearbeiter (pl.)	Verwaltungskräfte; Sachbearbeitende; Sachverständige
Sachbearbeiternummer	Kennnummer; Verwaltungsnummer; Nummer der zuständigen Verwaltungskraft
Sachverständiger	Person mit Sachverstand in ...
Salafist	salafistische Person
Sammler (pl.)	Sammelnde
Sänger (sg.)	Stimme; Act
Sänger (pl.)	Stimmen; Chor; Choraktive; Personen, die singen; Gesangsgruppe; Singende
Sanitäter (pl.)	Rettungskräfte; Sanitätsdienst
Säugling	[ist bereits genderneutral]
Schatzmeister (sg.)	Finanzvorstand; Kassenführung; Kassenverwaltung
Schauspieler (pl.)	Rollen; Besetzung; Darstellende
Schiedsrichter (sg.)	Spielleitung; schiedsrichtende Person; schiedsrichtendes Gremium; Schiedsgericht
Schirmherr	Support; gefördert/unterstützt von...
Schirmherrschaft	Support; gefördert/unterstützt von...; Vorstand; Repräsentanz
Schlägertyp	gewalttätige Person
Schlagmann [Rudern]	Schlagperson; taktangebende Person
Schlichter (pl.)	Schlichtende; Schlichtungspersonen
Schmied	auf die Schmiedekunst spezialisierte Person
Schneemann	Schneefigur
Schöffe	Schöffendienst leistende Person; ehrenamtlich richtende Person
Schöpfer (sg.)	(er-)schaffende Person
Schöpfer (pl.)	(Er-)Schaffende
Schreiber (sg.)	schreibende Person
Schriftführer	schriftführende Person; Protokoll
Schriftsteller (sg.)	bücherschreibende Person
Schriftsteller (pl.)	Urheberrechtsinhabende; Verfassende; Schreibende; Literaturschaffende
Schuhmacher	schuhherstellende Fachkraft
Schulabbrecher (pl.)	Geringqualifizierte; Menschen ohne Schulabschluss
Schulbegleiter	Schulbegleitung
Schuldiger (sg.)	schuldige Person
Schuldige (pl.)	[im Plural ist dieses Wort schon gendergerecht]
Schuldner (sg.)	die in Schuld stehende Person
Schüler (sg.)	Schulkind; Klassenmitglied; lernende Person
Schüler (pl.)	Schulkinder; Kinder; Jugendliche; die Klasse; Lernende; Beschulte; Klassenmitglieder; Mädchen und Jungen; Schülerschaft; Schülis
Schüleraustausch	Schulaustausch
Schülerausweis	Schulausweis
Schülerbegegnung	Schulbegegnung; Klassenbegegnung
Schülerexperiment	Gruppenexperiment; Klassenexperiment; Einzelexperiment
Schülerfahrtkosten	Schulfahrtkosten; Schulwegkosten; Exkurskosten; Fahrtkosten
Schülerfirma	Juniorfirma; 
Schülerlabor	Schullabor
Schülerpraktikum	Schulpraktikum; Praktikum in der Schulzeit
Schülervertreter (sg.)	Person, die die Schülerschaft vertritt; Lernendenvertretung
Schülervertreter (pl.)	Schulkindervertretung; Vertretung der Lernenden; Schülerschaftsvertretung 
Schülervorstellungen	Schulaufführungen; Projektvorstellung; Musikaufführung; Theateraufführung; Konzert; Talentshow; Aufführung
Schülerzeitung	Schülerschaftszeitung; Schülizeitung; Zeitung der Lernenden; Zeitung der Lerngemeinschaft
Schulleiter	Schulleitung
Schulsozialarbeiter	Fachkraft für Schulsozialarbeit
Schulträger	Schulträgerschaft
Schulungsleiter	Schulungsleitung
Schuster	Schusterwerkstatt; Schusterei
Schütze	schießende Person; Schuss abgebende Person/Dienstkraft
Schützenkönig	treffsicherste Person
schwangere Frauen	Schwangere
Schwätzer	Person mit losem Mundwerk; Unsinn redende Person
Schwesternzimmer	Dienstzimmer; Stationszimmer; Pflegestützpunkt
Schwiegermutter /-vater (sg.)	Schwiegerelternteil
Schwimmer (sg.)	schwimmende Person; Mensch mit Spaß am Schwimmen
Schwimmlehrer (sg.)	Schwimmlehrkraft
Schwimmmeister	Badeaufsicht
Schwimmmeisterraum	Raum der Badeaufsicht
Seefahrer (pl.)	Seeleute
Seemann	Hochsee-Fachkraft; maritime Fachkraft
Segler (sg.)	segelnde Person; Person im Segelsport
seinerzeit	zu jener Zeit; damals; einst; früher
seinesgleichen	von gleicher Art
Seiteneinsteiger	Person mit Seiteneinstieg/Quereinstieg
Seiteneinsteigerlehrgang	Seiteneinstiegslehrgang
Seiteneinsteigerprogramm	Seiteneinstiegsprogramm
Sekretärin	Verwaltungskraft; Assistenz; Schreibkraft; Bürokraft
Sekretärinnen	Verwaltungskräfte; Verwaltungsfachangestellte; Assistenzen; Schreibkräfte; Bürokräfte
Selbstabholer	bei Selbstabholung
Selbstdarsteller	sich selbst darstellende Person
Selbstmörder (sg.)	einen Suizid begehende Person
Selbstständiger (sg.)	selbstständig arbeitende Person
Seminarleiter (sg./pl.)	Seminarleitung
Sender (sg.)	gesendet von ...
Sender-Empfänger-Problem [Kommunikation]	Sende-Empfang-Problem
Sender-Nachricht-Empfänger-Modell	Kommunikationsmodell
Sender (pl.)	Sendende
Senioren	ältere Menschen; Menschen im Rentenalter; Menschen im 3. Lebensalter
Seniorenbeirat	Älterenbeirat; Ruhestandsbeirat; Beirat für das 3. Lebensalter
Seniorenangebot	Angebote für ältere Menschen
Servicemitarbeiter	Service; Service-Profi; Servicefachkraft
Sexist	sexistische Person
Showmaster	Showleitung; Showmoderation; moderierende Person
Sicherheitsbeauftragter	für Sicherheit zuständige/beauftragte Person; für Sicherheitsthemen zuständige/beauftragte Person
Siedler (pl.)	Ansässige; Siedelnde
Sieger (sg.)	Erster Platz; erstplatzierte Person
Siegerehrung	Bestenehrung; Bestenauszeichnung; Ehrung der gewinnenden Personen
Sitznachbar	Person neben mir; nebenan sitzende Person
... Diskutiere mit deinem Sitznachbarn.	... Diskutiere mit der Person neben dir.
Skeptiker (sg.)	(an etwas) zweifelnde Person
... die Argumente der EU-Skeptiker	... die Argumente der an der EU zweifelnden Menschen
Sklave	versklavte Person; in Sklaverei gehaltene Person; unfreier Mensch; leibeigene Person
Sklaven	Versklavte; in Sklaverei Gehaltene; Unfreie; Leibeigene
Sklavenhalter (pl.)	Sklaverei Ausführende
Softwareentwickler	Software entwickelnde Person
Soldaten	Streitkräfte im strengen Sinne nicht korrekt: auch zivile Angestellte, Beamt*innen und Auftragnehmende können Mitglieder der Streitkräfte sein
Solist	Solopart
Sozialarbeiter (sg.)	Fachkraft für Soziale Arbeit
Sozialarbeiter (pl.)	Sozialarbeitende; Fachkräfte der Sozialen Arbeit
Sozialleistungsträger (pl.)	Sozialleistungstragende
Sozialisten	sozialisitsche Personen; sozialistisch eingestellte Personen
Sozialpädagoge	sozialpädagogische Fachkraft
Sozialversicherungsfachangestellter	in der Sozialversicherung fachangestellte Person
Späher (sg.)	ausspähende Person
Sparer (pl.)	Sparenden
Sparringspartner	sich mit XY sparrende Person
Spaßverderber	Spaßbremse
Spaziergänger (sg.)	Person zu Fuß; spazierende Person; wandernde Person; Wandersperson
Spaziergänger (pl.)	Personen zu Fuß
Spediteur	für den Warentransport beauftragte Person
Spekulant	spekulierende Person
Spender (pl.)	Gebende; Sponsoring; Spenden
Spezialist	auf [Thema] spezialisierte Person
Spezialisten (pl.)	Sachkundige; Fachleute; Sachverständige
Spezialistenfunktion	Sachkundigenfunktion
Spieler (sg.)	Teammitglied
Spieler (pl.)	Spielende; Teammitglieder
Spielergruppen	Teams, Gruppen
Spielleiter	Spielleitung; Spielmoderation
Spielverderber	Spielverderbende Person; Spaßbremse
Spion	auskundschaftende Person; spionierende Person
Spitzbubenleiter	Steighilfe; Raubleiter; Baumleiter; Dachlattentreppe
Spitzenvertreter	Spitzenvertretung
Sprachschüler (pl.)	Sprachlernende; Spracherlernende
Sprecher (sg.) [Radio, Fernsehen, Hörbuch]	Stimme; Text gesprochen von; Moderation; Kommentar; Ansage; sprechende Person
Sprecher [einer Organisation, Gruppe]	Sprachrohr; Pressestelle; Öffentlichkeitsarbeit
Sprecher (pl.) [einer Sprache]	Sprechende; Sprachbenutzende
Sprecher (pl.)	Abgeordnete
Sprecherwechsel	Turn-Taking; Redeübernahme; Vergabe des Rederechts
Sprengbefugter	sprengbefugte Person
Sprengberechtigter	sprengberechtigte Person
Springer/Springerdienst	Ersatz; Vertretung; Stellvertretung
Sponsoren	Sponsoring; geldgebende Personen/Firmen; unterstützende Personen/Firmen; Sponsoringkreis; Sponsoringbeteiligte
Sportfreunde	Mitglieder des/unseres Vereins
Sportler (sg.)	sporttreibende Person; sportlich aktiver Mensch; Aktivmensch; Fitmensch
Sportler (pl.)	Sporttreibende; sportlich Aktive; 
Staatsbürgerschaft	Staatsangehörigkeit; Nationalität
Staatsmänner	Volksbeauftragte; Menschen in der Politik; Mitglieder des Bundestags / Bundesrats / der Regierung / ...; MdB
Stadtführer	Stadtführung; Reiseleitung; [ist das Buch / der Prospekt gemeint, muss nicht gegendert werden]
Stakeholder	Anspruchsgruppe; Interessenvertretung
Star	berühmte Persönlichkeit; Berühmtheit [einige empfinden den Begriff Star bereits genderneutral, z.B. Sie ist ein Star.]
Statist	stumme Rolle; Person ohne Sprechrolle; Nebenfigur
Steinewerfer (pl.)	Steinewerfende; Steine werfende Personen
Steinmetz	Stein bearbeitende Person
Stelleninhaber (sg.)	Stelle ausführende Person; Funktion bekleidende Person
Stellvertreter (sg.)	Stellvertretung
Sterbender	sterbende Person
Steuerberater (sg.)	Steuerberatung; Steuerkanzlei; zu Steuern beratende Person; der steuerberatenden Berufe angehörige Person
Steuerberater (pl.)	Angehörige der steuerberatenden Berufe
Steuerberaterpraxis	Steuerberatungspraxis
Steuerhinterzieher (pl.)	Steuerhinterziehende
Steuerschuldner (sg.)	steuerschuldige Person; abgabenpflichtige Person
Steuerzahler (sg.)	steuerzahlende Person; steuerpflichtige Person
stiefmütterlich	stiefelterlich; achtlos; nachlässig; gleichgültig; lieblos
Stifterrat	Stiftungsrat
Stifterversammlung	Stiftungsversammlung
Stimmzähler (sg.)	Stimmen zählende Person; Stimmen zählendes Mitglied
Stipendiat	geförderte Person
Stipendiaten	Studierende mit Stipendium; Geförderte
Störer (pl.)	Störende
Strafgefangener	Person in Haft
Sträfling	Person in Haft
Straftäter	straffällige Person
Strahlemann [bei Babys]	Sonnenschein
Stratege	strategisch agierende Person; planvoll handelnde Person
Streamer (pl.)	Streamende
Strichmännchen	Strichfigürchen; Strichmensch; Strichmenschlein
Strohmann	Strohmensch; Strohfigur
Strohmänner	Strohleute
Student	Studi; Mitglied der Studierenden
Studenten	Studierende; Studis
Studentenjob	Studierendenjob; Studijob; Job
Studentenstadt	Studi-Stadt; Universitätsstadt; Studierendenstadt; Hochschulstadt
Studentenwerk	Studierendenwerk
Studentenwohnheim	Studierendenwohnheim
Studienanfänger (pl.)	Studienbeginnende; Erstis; Erstsemestrige
Studienaussteiger (pl.)	Studienabbrechende
Studienbewerber (pl.)	Studienbewerbungen; Einschreibungen
Subunternehmer	Subunternehmen
Supervisor	Person mit Führungsverantwortung; Person mit leitender Funktion/mit Kontrollfunktionen; Person, die Supervision anbietet
Supervisoren	Supervidierende
Supporter (pl.)	Mitwirkende; Befürwortende
Sympathisant	sympathisierende Person
Systemadministrator	Systemadmin; Systemadministration
Systembetreuer	Systembetreuung
Tagesmutter	Tagespflege(person); Tagesbetreuung; Kinderbetreuung; Tageselter laut Duden: der oder das Elter (Singular von Eltern)
Tagesmütter	Tageseltern
Talkmaster (sg.)	Moderation; moderierende Person
Tante-Emma-Laden	Minimarkt; Laden für Waren des täglichen Bedarfs
Tanten und Onkel	Geschwister der Eltern
Tänzer (pl.)	Tanzende; Tanzbegeisterte
Tatbeteiligter (sg.)	an einer Tat beteiligte Person
Tatbeteiligte (pl.)	[im Plural ist dieses Wort schon gendergerecht]
Täter (sg.)	Unrechtsperson; straffällig gewordene Person
Täter (pl.)	Unrechtspersonen; Tatbegehende; Kriminelle; (Straf-)Tat begangen von...
Täterrolle	Tatbegehende
Taucher (sg.)	Tauchsport ausübende Person; tauchende Person
Täufling	Taufkind; getauft werdende Person; zu taufende Person
Teamleiter (sg.)	Teamleitung
Teampartner (sg.)	Teammitglied;
Teampartner (pl.)	Teammitglieder; Teambeteiligte (Personen)
Teamplayer	teamfähige Person
Techniker (sg.)	technische Fachkraft
... staatlich anerkannter Techniker	... Technische Fachkraft mit staatlicher Anerkennung; staatlich anerkannte Fachkraft im Bereich Technik
Technologe	Technologiefachkraft
Teilnehmer (sg.)	mitwirkende Person; teilnehmende Person
Teilnehmer (pl.)	Teilnehmende; Beteiligte; alle, die an ... teilnehmen; Anwesende; Anmeldungen
Teilnehmergebühr	Teilnahmegebühr; Kursgebühr; Kosten
Teilnehmerliste	Teilnahmeliste; Anwesenheitsliste; Teilnehmendenliste
teilnehmerorientiert	subjektorientiert; personorientiert; teilnehmendenorientiert; gruppenorientiert
Teilnehmerzahl	Teilnahmezahl; Gruppengröße; Anmeldezahl
Telemitarbeiter (sg.)	Remote-Personal; Tele-Personal
Telemitarbeiter (pl.)	Telemitarbeitende; Tele-Personal; Remote-Personal
Terrorist	des Terrors verdächtigte Person; eines Terroranschlags überführte Person
Terroristen	Terrorisierende
Tester (pl.)	Testende; Testpersonen
Testleiter (sg.)	Testleitung
Theaterpädagoge	theaterpädagogische Fachkraft
Theoretiker (pl.)	theoretisch Arbeitende
Therapeut	therapeutisches Fachpersonal
Therapeuten	Therapierende
Tierarzt	tiermedizinisches Fachpersonal
Tierhalter	tierhaltende Person
Tierschützer (sg.)	im Tierschutz engagierte Person
Tierschützer (pl.)	Tierschützende
Tischnachbar	Person neben dir; nebenansitzende Person
Tontechniker	tontechnische Fachkraft
Töpfer (sg.)	töpfernder Mensch
Torhüter	torhütende Person
Torwart	torhütende Person
Tourguide	Tourleitung; Reiseleitung
Touristen	Urlaubsgäste siehe Anmerkung unter 'Gäste'
Träger	Trägerschaft; verantwortliche Einrichtung/Körperschaft
Träger (pl.)	[im Sinne von Kleidungsstücke tragen] Tragende
Trainer (sg.)	Übungsleitung; moderierende Person
Trainer (pl.)	Moderierende; Referierende; Vortragende; Unterrichtende; Lehrende
Transatlantiker (pl.)	Menschen (in der Politik) mit transatlantischen Gedanken
Trauzeuge	die Trauung bezeugende Personen; Trauungsbegleitung
Trauzeugen	die Trauung Bezeugende; Trauungsbegleitung
Treuhänder	treuhändisch beauftragte Person
Trompeter	Trompete spielende Person
Tüftler	tüftelnde Person
der Türke [im Sinne vom Gemüse-/Obstladen]	türkischer Gemüse-/Obstladen; Laden um die Ecke; kleiner Gemüseladen
Turnschwestern	Turngeschwister
Tutor	studentische Hilfskraft; Übungsgruppenleitung; Tutoriumsleitung
Tutoren	Übungs(an)leitende; Tutoriumsbegleitende; Ratgebende; Begleitung; studentische Hilfskräfte
Überbringer	überbringende Person
übermannen	überkommen; überwältigen
übermannt werden	überwältigt werden
... von Gefühlen übermannt werden	... von Gefühlen überwältigt werden; sich von Gefühlen hinreisen lassen
Übersetzer (pl.)	Übersetzende; Literatur Übersetzende
Übungsleiter (sg.)	sportliche/technische/praktische Anleitung; anleitende Person
Umfrageteilnehmer (pl.)	Befragte
Umschüler (pl.)	Umlernende; Umschulende; die zu Qualifizierenden; Personen in beruflicher Neuorientierung
Unbekannter	unbekannte Person
unbemannt	ohne Besatzung; maschinengesteuert; autonom; ferngesteuert; unbesetzt; robotisch; personenlos
Unternehmer (sg.)	Gewerbe betreibende Person; selbstständige Person; Unternehmensleitung
Unternehmer (pl.)	Selbstständige; Wirtschaftstreibende; Geschäftsleute; Gewerbe Betreibende
Unterstützer (sg.)	support; Förderung durch ...; unterstützendes Unternehmen; unterstützende Person
Unterstützer (pl.)	support; Geldgebende; Förderung durch ...; Mitwirkende; Befürwortende
Unterzeichner (sg.)	unterzeichnende Person; unterzeichnende Partei; Unterschrift
Unterzeichner (pl.)	Unterzeichnende; Unterschriften
Urheber	Person der Urheberschaft
Recht auf Urheberschaft;
Copyright juristisch etwas anderes: Copyright ist ein Verwertungsrecht, das abgegeben werden kann; Urheberrecht kann nicht abgegeben werden
Urheberrecht	;
Urlauber (sg.)	reisende Person; urlaubende Person
Urlauber (pl.)	Reisende
User (pl.)	Nutzende; Personen, die Apps/Software nutzen; Mitglieder
V-Mann	V-Person
V-Männer	V-Leute
Vater	Elternteil
Vaterland	Heimatland; Geburtsland; Erstland
väterlicherseits	[vornamen-]licherseits	bei gleichgeschlechtlichen Elternpaaren, z.B. janlicherseits, olaflicherseits
Veganer	vegan lebende Person
Vegetarier	vegetarisch lebende Person
Veranstalter (sg.)	veranstaltet durch/von ... ; Organisation; Ausrichtung
Veranstalter (pl.)	Einladende; veranstaltet durch/von ... ; Organisation; Ausrichtung
Verantwortlicher (sg.)	die Verantwortung tragende Person; verantwortliche Person
Verantwortliche (pl.)	[im Plural ist dieses Wort schon gendergerecht]
Verbandsgesellschafter (pl.)	Vertretungen / Beteiligte der Verbände
Verbandsvertreter (pl.)	Vertretungen / Beteiligte der Verbände
Verbraucher (pl.)	Kundschaft; Konsumierende; Privatpersonen; Verbrauchende;
Verbraucherpreise	Verbrauchspreis; Verbrauchendenpreis; Konsumpreis; Preis
Verbraucherschutz	Konsumierendenschutz
Verbraucherschützer (sg.)	mit dem Verbraucherschutz beauftragte Person;
Verbrecher (sg.)	Person, die eine Straftat/ein Verbrechen begeht
Verbrüderung	Verschwisterung
Verbündeter	ein Bündnis einhaltende Person; verbündete Person
Verfasser (pl.)	verfasst von; Autorenschaft
Verfechter	für einen Standpunkt einstehende Person; für ... einstehende Person
Verfolger	verfolgende Person
Verfolgungsakteure	Verfolgende
Verhandlungspartner	Verhandlungsgegenseite; Verhandlungsgegenüber
Verkäufer (sg.)	Kaufhauspersonal; Personal; Verkaufskraft; Verkaufsperson; Geschäft; Onlineshop
Verkäufer (pl.)	Kaufhauspersonal; Personal; Verkaufskräfte; Anbietende; Handeltreibende; Verkaufende
Verkehrssünder (sg.)	Verkehrsregeln missachtende Person; gegen Verkehrsregeln verstoßende Person
Verkehrsteilnehmer (pl.)	Verkehrsbeteiligte
Verleger (pl.)	Publizierende
Verleiher (sg.)	verleihende Person
Verletzter (sg.)	verletzte Person
Verlierer (sg.)	der letzte Platz
Verlierer (pl.)	die Letzten
Verlobter (sg.)	verlobte Person
Verlobte (pl.)	[im Plural ist dieses Wort schon gendergerecht]
Vermieter (sg.)	vermietende Person
Vermittler (sg.)	Mittelsperson
Versender	versendende Person; versendet von ...
Versichertenkarte	Versicherungskarte; Gesundheitskarte; Krankenkassenkarte
Versichertennummer	Versicherungsnummer
Versicherungsnehmer (sg.)	Versicherung abschließende Person
Versicherungsnehmer (pl.)	Personen, die Versicherung abschließen, Versicherung abschließende Personen
Verstorbener	verstorbene Person
Versuchsleiter (sg.)	Versuchsleitung
Verteidiger (sg.)	Verteidigung; Rechtsvertretung
Vertragspartner (sg.)	Vertragspartei; Vertragsperson
Vertragspartner (pl.)	Vertragsparteien
Vertreter (sg.)	in vertretender Position; Mitglied von ...
Vertreter (pl.)	vertreten durch; Vertretung; Delegierte; Abgesandte; Abgeordnete; Beauftragte; Mitglieder; Vertretende
... Vertreter der Presse	... Mitglieder der Presse
... gesetzlicher Vertreter	... gesetzliche Vertretung; gesetzlich vertretende Person
Vertriebler (pl.)	Vertriebsmitarbeitende
Verursacher (sg.)	verursachende Person
Verursacher (pl.)	Verursachende
Verwalter	verwaltende Person/Firma/Institution; Verwaltung
Verwandter (sg.)	Familienmitglied
Verwender (sg.)	verwendende Person
Verwender (pl.)	Verwendende
Veteran	altgediente Person
Veteranen	Altgediente; ehemalige Kriegsteilnehmende
Veterinär	Fachkraft für Tiermedizin; Tiere heilende Person
Virologen (pl.)	Menschen mit Fachgebiet Virologie; medizinisches / ärztliches Fachpersonal mit Expertise in Virologie
Visionär	Person mit Weitblick; Person mit Visionen
Vizevorsitz; Vizepräsidentschaft; Vize; 2. vorsitzende Person der Präsidentschaft
Volkswirte / Volkswirtschaftler (pl.)	Fachleute der Volkswirtschaft; Graduierte der Volkswirtschaft; Studierende der Volkswirtschaft
Volontärsbeauftragter	beauftragte Person fürs Volontariat
Vordenker (sg.)	vordenkende Person; Weg bereitende Person
Vordermann	Person davor; Person, die davor kam; vorausgehende Person
... Halten Sie 1,5m Abstand zum Vordermann.	... Halten Sie 1,5m Abstand zu anderen. / ... Halten Sie 1,5m Abstand zur Person vor Ihnen.
Vorgänger	vorangegangene Person; Person vor mir
Vorgängerprojekt	Vorprojekt; vorangegangenes Projekt
Vorgängerstudie	Vorstudie; vorangegangene Studie
Vorgesetzter	Führungskraft
Vormund	die Vormundschaft innehabende Person; Vormundschaft
... Vormund ist Frau Schulz.	... Die Vormundschaft hat Frau Schulz.
Vorredner	Person, die eine Rede gehalten hat; Person vor mir
Vorreiter	Person an der Spitze; Person, die etwas vorlebt; Person, die voraus denkt/handelt
Vorreiterrolle	Führungsrolle
Vorsitzender (sg.)	den 1. Vorsitz hat ...
Vorstand (sg.)	Vorstandsmitglied; im Vorstand
... Wer sind die anderen Vorstände?	... Wer sind die anderen Vorstandsmitglieder? / Wer ist noch im Vorstand?
Wachmann	Wachpersonal
Wächter (sg./pl.)	Wache
Wähler (pl.)	Wahlberechtigte; alle, die zur Wahl gegangen sind; Stimmberechtigte; Wahlvolk
Wahlhelfer	Wahlhilfe; bei der Wahl helfende Person
Wählerinitiative	Initiative der Wahlberechtigten
Wählerverzeichnis	Wählendenverzeichnis
Wählerstimme	Wahlstimme
Wahlmänner	Wahlleute
Waidmannsheil!	Waidleutsheil!
Waise	[dieser Begriff ist bereits genderneutral]
Wanderer (sg.)	wandernde Person; Person auf Wanderung
Wart	überwachende Person
Wärter	Betreuung
Wegbegleiter (sg.)	wegbegleitende Person; Wegbegleitung
Wegbereiter (sg.)	Weg bereitende Person; prägende Person
Wegewart	Wege überwachende Person
Weggefährte	Wegbegleitung
Weggefährten	Wegbegleitungen; den Weg begleitende Personen 
Weinkenner (pl.)	Weinbegeisterte
Weltenbummler (pl.)	Weltreisende
weltmännisch	kosmopolitisch; weltgewandt
Weltmarktführer (pl.)	Weltmarktführende
Werkstudent	Werkstudi; studentische Hilfskraft; studentische Stelle; studentischer Job
Werkstudenten	Werkstudierende
Werkstudentenstelle	Werkstudierendenstelle
Werkzeugmechaniker	Fachkraft für Werkzeugmechanik
Wettbewerber (sg.)	Konkurrenz; Wettbewerbsteilnehmende
Widersacher	Widerpart; Konkurrenz
Widerstandskämpfer (pl.)	Widerstandsleistende
Wiederholer (pl.) [z.B. einer Prüfung]	Wiederholende
Wikipedianer	Menschen hinter Wikipedia; Mitwirkende bei Wikipedia
Wilderer	wildernde Person; Person, die wildert; Person, die unbefugt jagt
Winzer (sg.)	Weinbau betreibende Person
Wirtschaftsprüfer (pl.)	Angehörige der wirtschaftsprüfenden Berufe
Wirtschaftswissenschaftler (pl.)	Forschende der Wirtschaft(swissenschaft); Fachleute der Wirtschaftswissenschaft
Wissenschaftler (sg.)	Mensch aus der Wissenschaft; forschende Person
Wissenschaftler (pl.)	Forschende; wissenschaftliches Personal der Universität; Menschen aus der Wissenschaft; wissenschaftliche Arbeitskraft
wissenschaftlicher Mitarbeiter	wissenschaftlich mitarbeitende Person; wissenschaftliche Fachkraft
wissenschaftliche Mitarbeiter	wissenschaftliche Mitarbeitende
Wissensträger	Wissenstragende Person; des Wissens mächtige Person
Witwer (pl.)	Verwitwete
Wohnungseigentümer (pl.)	Wohnungsinhabende
Workshopleiter (sg./pl.)	Workshopleitung
Xylophonspieler (pl.)	Xylophon Spielende
YouTuber	auf Youtube arbeitende/performende Person; Person auf Youtube; einen Youtube-Kanal betreibende Person;
Zahlungsempfänger	Zahlung empfangende Person
Zahnarzt	zahnärztliches Fachpersonal; Fachkraft der Zahnmedizin; zahnmedizinisches Fachpersonal
Zahnarztpraxis	Praxis für Zahnerhaltung; zahnmedizinische Praxis; Praxis für Zahnmedizin
Zauberer (sg.)	Zaubertrick vorführende Person; Zauberkraft ausübende Person
Zauberer (pl.)	Zauberkunstschaffende
Zehnkämpfer (sg.)	am Zehnkampf teilnehmende Person
Zeitarbeitnehmer (pl.)	Zeitarbeitnehmende
Zeitgenosse	Mitmensch
Zeitwächter	Zeitwache
Zeitzeuge	zeitbezeugende Person; vor Ort gewesene Person
Zeuge	bezeugende Person
Zeugen	Bezeugende
Zimmerer	Zimmereifachkraft
Zimmermädchen	Servicekraft; Raumpflege; Reinigungskraft
Zimmermann	Zimmereifachkraft
Zivilist	Zivilperson
Zivilisten	Zivilpersonen
Züchter	Fachperson Tier-/Pflanzen-/...-Zucht
Zugang für Rollstuhlfahrer	barrierefreier Zugang
Zuhörer (pl.)	Publikum; Auditorium; Zuhörerschaft
Zulieferer	Zulieferfirma
Zuschauer (sg.)	Person aus dem Publikum
Zuschauer (pl.)	Publikum; Zuschauende
Zuschauerquote	Einschaltquote
Zuschauerraum	Zuschauraum; Publikumsraum
Zuschauerzahl	Publikumszahl
Zuständiger	zuständige Person
Zuwanderer (pl.)	Zugewanderte; Personen mit Migrationshintergrund; Eingewanderte; Migrierte
Zweifler (pl.)	Zweifelnde